"playername","id","Ratings","games","games_won","Hard_Ratings","Hard_games","Hard_games_won","Grass_Ratings","Grass_games","Grass_games_won","Clay_Ratings","Clay_games","Clay_games_won","Carpet_Ratings","Carpet_games","Carpet_games_won","NotHard_Ratings","NotHard_games","NotHard_games_won","Bo3_Ratings","Bo3_games","Bo3_games_won","Bo5_Ratings","Bo5_games","Bo5_games_won"
"abdulla m",1,1491.72524463075,1,0,1488.33861813623,1,0,1500,0,0,1500,0,0,1500,0,0,1500,0,0,1491.52210987077,1,0,1500,0,0
"abel m",2,1464.14827410057,9,2,1473.85607794042,5,1,1491.03469087827,1,0,1490.33042288906,3,1,1500,0,0,1481.40170277464,4,1,1470.4335531043,8,2,1484.73478182651,1,0
"acasuso j",3,1597.88775166957,359,181,1521.62158518592,106,42,1406.23436294037,8,0,1636.54328287755,233,135,1455.59892868514,12,4,1609.76566330908,253,139,1593.17705753623,313,167,1427.53604483251,46,14
"adaktusson j",4,1490.65503274911,1,0,1489.46962825913,1,0,1500,0,0,1500,0,0,1500,0,0,1500,0,0,1500,0,0,1485.52307406227,1,0
"agaev e",5,1489.65024821517,1,0,1488.17194499842,1,0,1500,0,0,1500,0,0,1500,0,0,1500,0,0,1488.69325948349,1,0,1500,0,0
"agassi a",6,1810.86771303128,350,266,1820.35508042514,256,201,1596.98059967418,29,20,1664.30816948174,58,40,1534.6156575585,7,5,1675.59578644454,94,65,1789.29338947604,237,175,1788.15096788118,113,91
"agenor r",7,1392.84415329499,26,7,1450.78502335265,11,3,1487.5,3,1,1435.52180833583,12,3,1500,0,0,1424.485766117,15,4,1407.3655049372,22,6,1476.29961122624,4,1
"ager j",8,1473.56254948287,2,0,1500,0,0,1500,0,0,1475.16858467856,2,0,1500,0,0,1474.71971200426,2,0,1474.40244638499,2,0,1500,0,0
"agostinelli b",9,1485.30449349858,1,0,1485.84836184244,1,0,1500,0,0,1500,0,0,1500,0,0,1500,0,0,1485.77717841385,1,0,1500,0,0
"aguilar j",10,1473.46668256531,6,1,1500,0,0,1500,0,0,1471.76205279733,6,1,1500,0,0,1472.71271994591,6,1,1477.36094484033,5,1,1493.28570440508,1,0
"ahouda a",11,1488.94947730642,1,0,1500,0,0,1500,0,0,1489.5729383975,1,0,1500,0,0,1488.9150181755,1,0,1489.09459166811,1,0,1500,0,0
"al alawi s k",12,1477.35382814485,2,0,1476.70103448973,2,0,1500,0,0,1500,0,0,1500,0,0,1500,0,0,1476.67976854134,2,0,1500,0,0
"al ghareeb m",13,1470.41269001424,8,1,1471.42587090598,7,1,1500,0,0,1493.27009127925,1,0,1500,0,0,1493.14852645277,1,0,1466.6235119359,8,1,1500,0,0
"al khulaifi n g",14,1486.89499843964,1,0,1486.84237822244,1,0,1500,0,0,1500,0,0,1500,0,0,1500,0,0,1486.81939275256,1,0,1500,0,0
"al mutawa j",15,1487.4539746159,1,0,1487.72527698947,1,0,1500,0,0,1500,0,0,1500,0,0,1500,0,0,1486.50540747464,1,0,1500,0,0
"alami k",16,1378.96309897506,75,27,1397.35581182413,32,10,1488.75452877921,5,2,1453.65309855956,36,15,1475.44952970932,2,0,1432.01351662096,43,17,1373.16296880326,63,22,1480.63360785045,12,5
"albert m",17,1489.55271144519,1,0,1500,0,0,1500,0,0,1490.09725652494,1,0,1500,0,0,1489.5560200475,1,0,1489.33000475055,1,0,1500,0,0
"albot r",18,1451.00166209436,23,5,1444.50750763787,13,2,1502.82893911471,2,1,1478.38411236258,8,2,1500,0,0,1480.41661186839,10,3,1452.76182836381,17,4,1480.12711507161,6,1
"alcaide g",19,1494.56608155311,1,0,1500,0,0,1489.62058904115,1,0,1500,0,0,1500,0,0,1492.51340532996,1,0,1500,0,0,1491.03702851304,1,0
"aldi f",20,1442.89228746315,9,1,1500,0,0,1500,0,0,1452.01359035743,8,1,1488.14238272298,1,0,1440.05755618352,9,1,1443.39398369811,9,1,1500,0,0
"ali mutawa j m",21,1477.42927550162,2,0,1475.68863441225,2,0,1500,0,0,1500,0,0,1500,0,0,1500,0,0,1477.01944942725,2,0,1500,0,0
"allegro y",22,1453.04300722598,13,4,1472.17820361597,2,0,1472.3667747633,10,4,1492.38470504562,1,0,1500,0,0,1469.41699262192,11,4,1451.53720144139,13,4,1500,0,0
"almagro n",23,1635.9900822446,630,371,1597.92416165168,201,97,1494.80443693424,26,11,1701.53534441629,396,260,1489.30805999186,7,3,1681.32004042988,429,274,1608.64756580599,522,308,1652.41627155704,108,63
"alonso j",24,1457.35187948085,13,4,1450.02165411732,4,0,1500,0,0,1494.56608486708,9,4,1500,0,0,1493.29231352881,9,4,1468.42599846263,12,4,1487.5,1,0
"altamirano c",25,1494.72017866134,1,0,1492.90676588199,1,0,1500,0,0,1500,0,0,1500,0,0,1500,0,0,1500,0,0,1492.26623308467,1,0
"alund m",26,1532.64544280977,17,7,1500,0,0,1493.39449946782,1,0,1533.50710376813,16,7,1500,0,0,1531.31924277529,17,7,1540.90342226599,15,7,1483.98873512602,2,0
"alvarez e",27,1431.76308110988,20,7,1449.95738272428,4,0,1500,0,0,1475.83960745286,16,7,1500,0,0,1472.8038920054,16,7,1439.07398040582,19,7,1489.18457842916,1,0
"alves t",28,1427.93359069442,30,7,1448.12936894757,15,4,1488.82076767573,5,2,1448.34898094524,10,1,1500,0,0,1442.73657043661,15,3,1410.58255051079,21,4,1494.87878832044,9,3
"amritraj p",29,1473.76725373285,35,13,1398.82393139023,22,5,1539.40148979286,13,8,1500,0,0,1500,0,0,1537.70858812972,13,8,1475.23666139745,34,13,1486.44894022199,1,0
"ancic i",30,1525.58651361339,3,2,1500,0,0,1518.76347173794,3,2,1500,0,0,1500,0,0,1521.09393755829,3,2,1523.91336218523,3,2,1500,0,0
"ancic m",31,1748.57483283045,313,192,1726.49462275474,168,98,1710.80732804894,50,37,1638.71411427165,55,32,1595.82259371247,40,25,1718.19604429756,145,94,1705.76634753683,250,149,1720.86144016363,63,43
"andersen j",32,1485.09347235194,1,0,1485.79694588616,1,0,1500,0,0,1500,0,0,1500,0,0,1500,0,0,1485.62080435671,1,0,1500,0,0
"andersen j f",33,1474.29117144483,8,2,1487.95798780235,1,0,1500,0,0,1479.89991785005,7,2,1500,0,0,1479.44087193194,7,2,1467.26777437915,6,1,1502.5575359856,2,1
"anderson a",34,1494.9674289018,1,0,1493.09319725409,1,0,1500,0,0,1500,0,0,1500,0,0,1500,0,0,1493.85880238786,1,0,1500,0,0
"anderson k",35,1719.7044244709,408,230,1699.86190289753,283,164,1610.96828511067,47,26,1621.97743283279,78,40,1500,0,0,1678.30935046225,125,66,1704.37439356589,333,186,1685.97571915607,75,44
"anderson o",36,1490.63203438105,1,0,1489.82867466504,1,0,1500,0,0,1500,0,0,1500,0,0,1500,0,0,1490.63095143858,1,0,1500,0,0
"andersson h",37,1486.94935230995,1,0,1500,0,0,1500,0,0,1487.5,1,0,1500,0,0,1487.5,1,0,1487.5,1,0,1500,0,0
"andreev i",38,1533.04679069241,432,218,1521.7242948793,172,80,1498.26042543407,33,16,1542.28344244125,199,107,1527.46790530094,28,15,1525.48317027773,260,138,1557.03505485588,363,182,1534.77864023415,69,36
"andreozzi g",39,1499.7141184529,4,1,1490.87594406326,2,0,1500,0,0,1507.08141555221,2,1,1500,0,0,1507.00238101194,2,1,1507.44949243318,2,1,1487.87609214589,2,0
"androic t",40,1482.9962996956,2,0,1491.70021183743,1,0,1500,0,0,1489.12325936464,1,0,1500,0,0,1489.61295927401,1,0,1480.85376110378,2,0,1500,0,0
"andujar p",41,1537.04760410428,285,116,1426.71285958661,102,29,1403.7004891376,16,2,1616.83526184331,167,85,1500,0,0,1606.34920186901,183,87,1527.71561044561,244,102,1465.15682161767,41,14
"aranguren j m",42,1477.23536905117,2,0,1500,0,0,1500,0,0,1474.78192815828,2,0,1500,0,0,1474.78553583481,2,0,1477.21735644983,2,0,1500,0,0
"arazi h",43,1555.77237770384,220,111,1557.5866466058,105,55,1541.51724482312,23,13,1441.25996999097,66,27,1546.45958641424,26,16,1512.29830802485,115,56,1520.47414119272,171,83,1570.9127591895,49,28
"arguello f",44,1397.70133925127,16,1,1500,0,0,1491.64370856486,1,0,1395.92793717885,15,1,1500,0,0,1394.06865499894,16,1,1403.83790842316,14,1,1488.04686923223,2,0
"armando h",45,1447.79305079202,43,13,1502.81278823856,5,2,1500,0,0,1423.77082608555,38,11,1500,0,0,1424.95194174183,38,11,1455.54558986183,41,13,1477.96248225963,2,0
"arnaboldi a",46,1491.47352416267,10,3,1500,0,0,1500,0,0,1472.0239607966,10,3,1500,0,0,1477.02386829662,10,3,1485.35368092158,7,2,1495.45789616182,3,1
"arnold l",47,1485.72737509472,1,0,1500,0,0,1500,0,0,1486.73501941213,1,0,1500,0,0,1485.49446860097,1,0,1486.71676127911,1,0,1500,0,0
"arquez p",48,1487.15270559017,1,0,1500,0,0,1500,0,0,1488.06838758785,1,0,1500,0,0,1488.03885206101,1,0,1487.94784932942,1,0,1500,0,0
"arthurs w",49,1552.90258874056,240,104,1527.60968742788,142,61,1515.27469055713,49,26,1445.43473469889,44,15,1488.8767685833,5,2,1494.02692729229,98,43,1546.36018705251,191,84,1459.05231474414,49,20
"artunedo martinavarro a",50,1487.45085926054,1,0,1487.29720170454,1,0,1500,0,0,1500,0,0,1500,0,0,1500,0,0,1487.42923386278,1,0,1500,0,0
"arvidsson i",51,1490.30843471958,1,0,1500,0,0,1500,0,0,1487.62993270224,1,0,1500,0,0,1488.00053763668,1,0,1489.57657134433,1,0,1500,0,0
"ascione a",52,1499.02963830112,2,1,1501.11648253569,2,1,1500,0,0,1500,0,0,1500,0,0,1500,0,0,1499.66833596311,2,1,1500,0,0
"ascione t",53,1385.58374973145,73,21,1419.48566636143,32,10,1458.48157176948,4,0,1429.21028059914,29,9,1471.33222948711,8,2,1405.04369742021,41,11,1420.79293773586,58,19,1397.88568523802,15,2
"auckland j",54,1519.34756990972,3,2,1519.04517403687,3,2,1500,0,0,1500,0,0,1500,0,0,1500,0,0,1517.09061080894,3,2,1500,0,0
"authom m",55,1476.43038828325,2,0,1472.63634017184,2,0,1500,0,0,1500,0,0,1500,0,0,1500,0,0,1500,0,0,1468.18305753767,2,0
"awadhy o",56,1481.96279904438,2,0,1480.77462105492,2,0,1500,0,0,1500,0,0,1500,0,0,1500,0,0,1481.62607687184,2,0,1500,0,0
"ayala d",57,1486.31703391764,1,0,1486.27850466771,1,0,1500,0,0,1500,0,0,1500,0,0,1500,0,0,1486.5992555441,1,0,1500,0,0
"azzaro l",58,1470.65066949746,3,0,1500,0,0,1500,0,0,1468.94563163666,3,0,1500,0,0,1468.62931066696,3,0,1469.37892906859,3,0,1500,0,0
"baccanello p",59,1465.88082184078,9,2,1462.30085338938,7,1,1499.21945762656,2,1,1500,0,0,1500,0,0,1497.91149162464,2,1,1472.54985512719,6,1,1489.24960664756,3,1
"bachelot j f",60,1490.39910174388,8,3,1508.18210248048,2,1,1478.54089568452,2,0,1499.78700130664,2,1,1501.69814581689,2,1,1478.95553572416,6,2,1486.11692685507,5,2,1493.50351652261,3,1
"bachinger m",61,1499.40587624788,69,23,1478.15480044008,36,12,1467.90376381494,8,2,1461.75270319173,25,9,1500,0,0,1453.06642947666,33,11,1492.09194934984,59,21,1456.52117926834,10,2
"baghdatis m",62,1698.66138406876,525,289,1680.36881010209,349,196,1593.1704259456,79,47,1476.56838623674,75,30,1597.14796854893,22,16,1595.04801973793,176,93,1669.46694509576,419,228,1603.78366417195,106,61
"bagnis f",63,1478.88150421743,33,11,1486.92527660795,2,0,1477.61738732258,2,0,1493.58456859253,29,11,1500,0,0,1476.73235073072,31,11,1483.61997795713,25,9,1473.39095180014,8,2
"bahrouzyan o",64,1446.13619905686,7,0,1441.42704216749,7,0,1500,0,0,1500,0,0,1500,0,0,1500,0,0,1441.14879512606,7,0,1500,0,0
"bai y",65,1499.12044397729,7,2,1491.40831213025,7,2,1500,0,0,1500,0,0,1500,0,0,1500,0,0,1495.35312917476,7,2,1500,0,0
"baker b",66,1498.17079103982,59,20,1433.1820037739,39,10,1515.06051693302,10,5,1526.30662972612,10,5,1500,0,0,1538.0729241631,20,10,1483.45347095667,40,13,1482.79332749115,19,7
"baker j",67,1421.18315170678,19,3,1479.93699249129,2,0,1413.09731792174,17,3,1500,0,0,1500,0,0,1419.1402142285,17,3,1463.00404526748,12,3,1424.55772725265,7,0
"balazs a",68,1523.55568940845,7,4,1500,0,0,1500,0,0,1518.48150119151,7,4,1500,0,0,1522.55554154255,7,4,1522.34916105551,7,4,1500,0,0
"balcells j",69,1452.78185277687,78,35,1471.00775584022,35,15,1464.32167426039,3,0,1523.88057726771,39,20,1487.94952970932,1,0,1479.34520872848,43,20,1490.13266650381,67,33,1425.15277883906,11,2
"ball c",70,1492.14851558845,20,7,1514.34809002753,16,7,1474.63483004662,2,0,1479.54852853348,2,0,1500,0,0,1455.65820655928,4,0,1541.00094051993,9,5,1439.64870387704,11,2
"balleret b",71,1494.6552631761,11,3,1497.28682391321,3,1,1500,0,0,1483.16653311569,8,2,1500,0,0,1485.83275697346,8,2,1490.79756916469,11,3,1500,0,0
"baluda v",72,1493.63161173435,1,0,1493.22947710952,1,0,1500,0,0,1500,0,0,1500,0,0,1500,0,0,1493.61261977483,1,0,1500,0,0
"barrere g",73,1484.65475307655,2,0,1486.58077669097,1,0,1500,0,0,1492.85752689063,1,0,1500,0,0,1493.40601513702,1,0,1487.718355987,1,0,1491.35448448187,1,0
"barrientos n",74,1457.41281105689,3,0,1500,0,0,1500,0,0,1462.09976688333,3,0,1500,0,0,1460.73419832244,3,0,1457.84741852574,3,0,1500,0,0
"barton m",75,1530.84303157954,6,3,1516.47613607718,2,1,1503.28413720551,2,1,1503.07695361594,2,1,1500,0,0,1508.13743583813,4,2,1523.29770809671,4,2,1505.69139753408,2,1
"basic m",76,1517.02042487305,11,5,1514.04049694637,6,3,1499.31425056277,2,1,1489.59569142039,3,1,1500,0,0,1492.94940559899,5,2,1502.52462738238,9,4,1509.3110460226,2,1
"basilashvili n",77,1516.36183101472,27,10,1485.50083137134,15,4,1520.96827955964,3,2,1499.9486675273,9,4,1500,0,0,1516.73526313084,12,6,1515.52954650044,20,8,1486.49049123175,7,2
"bastl g",78,1426.26727316389,114,40,1449.79594195029,74,30,1418.92718924981,15,3,1426.16588855707,12,2,1463.98021096773,13,5,1379.34412467442,40,10,1428.08759179396,101,37,1443.85203990981,13,3
"bautista agut r",79,1702.19018462573,41,25,1619.40909938255,23,14,1518.40194408454,5,3,1581.32684024255,13,8,1500,0,0,1596.02721676954,18,11,1660.22822277539,32,19,1548.6372317585,9,6
"bautista r",80,1852.48147408685,221,132,1803.70783733308,146,86,1602.18539990434,19,13,1666.10691598541,56,33,1500,0,0,1697.20988192504,75,46,1809.00117056962,182,107,1675.24539384456,39,25
"beck a",81,1432.07275651237,99,38,1458.45694106792,35,13,1517.47653203182,14,7,1430.08083636978,48,17,1499.33123583816,2,1,1450.09030277126,64,25,1430.03414578672,77,30,1473.20277462535,22,8
"beck k",82,1411.21691622261,170,60,1425.72298953554,102,36,1468.30283278589,31,13,1365.37160563014,22,2,1537.87484604146,15,9,1444.03368205722,68,24,1418.07659006479,133,47,1455.45583594831,37,13
"becker b",83,1517.2414854971,365,152,1504.43891358873,250,102,1548.41699449743,66,36,1400.11567442425,43,11,1512.47027527241,6,3,1517.5916895226,115,50,1506.69530454218,311,133,1476.45447611092,54,19
"bedene a",84,1557.31580930727,117,49,1553.68743199691,57,27,1488.45864517028,14,5,1490.2087878084,46,17,1500,0,0,1501.89129897729,60,22,1541.41008686093,99,45,1455.09488192583,18,4
"behr n",85,1494.82155953551,9,4,1495.70355872808,9,4,1500,0,0,1500,0,0,1500,0,0,1500,0,0,1494.51950689455,9,4,1500,0,0
"behrend t",86,1403.73399999412,109,39,1401.64451499198,35,11,1454.38815476486,4,0,1465.06294874486,65,25,1512.90595168759,5,3,1444.41360919838,74,28,1418.32963794257,93,37,1400.86137021932,16,2
"behrmann m",87,1486.00396951114,1,0,1484.08545788201,1,0,1500,0,0,1500,0,0,1500,0,0,1500,0,0,1486.50958144453,1,0,1500,0,0
"belal c",88,1486.73805203815,1,0,1500,0,0,1500,0,0,1488.93895204411,1,0,1500,0,0,1488.51749354491,1,0,1486.83891187528,1,0,1500,0,0
"belic l",89,1470.80152472389,3,0,1500,0,0,1500,0,0,1466.39855000597,3,0,1500,0,0,1468.45986606276,3,0,1467.46497500783,3,0,1500,0,0
"bellier a",90,1489.07331837495,1,0,1500,0,0,1500,0,0,1489.03256784695,1,0,1500,0,0,1489.02843837948,1,0,1489.07114456571,1,0,1500,0,0
"bellucci t",91,1623.89349621835,337,163,1563.93167491915,143,57,1483.82811281631,15,6,1609.13826020271,179,100,1500,0,0,1597.41054159532,194,106,1621.19140492727,284,141,1495.89172741249,53,22
"belyaev i",92,1491.26475157696,1,0,1489.27099778992,1,0,1500,0,0,1500,0,0,1500,0,0,1500,0,0,1490.43636668082,1,0,1500,0,0
"bemelmans r",93,1511.4152591317,41,13,1514.27212591467,24,9,1444.1694504273,13,3,1477.61579982869,4,1,1500,0,0,1452.61356457678,17,4,1499.77207526555,30,10,1468.74654438759,11,3
"benneteau a",94,1487.3367635368,1,0,1488.05114545852,1,0,1500,0,0,1500,0,0,1500,0,0,1500,0,0,1500,0,0,1487.20665701196,1,0
"benneteau j",95,1618.96392511513,515,248,1595.13062947995,319,158,1522.67293467688,64,30,1511.73937548017,104,45,1548.35472365159,28,15,1530.13993779934,196,90,1638.986668804,424,206,1538.30898513002,91,42
"berankis r",96,1530.47261897911,132,57,1573.5672489505,99,50,1413.10707964592,13,2,1425.1638729615,20,5,1500,0,0,1381.02780254682,33,7,1530.27503824734,106,47,1484.15694451069,26,10
"berasategui a",97,1402.5313219263,19,4,1451.22763354439,6,1,1488.33419129852,1,0,1440.80407711489,12,3,1500,0,0,1433.31949961214,13,3,1425.31812714848,16,4,1463.38290646128,3,0
"berdych t",98,1889.65385707578,812,532,1845.40919321465,518,339,1718.87515260569,82,58,1840.30636926418,191,121,1574.96247292419,21,14,1852.09660297097,294,193,1829.87743527103,629,401,1873.25614658745,183,131
"berlocq c",99,1597.3579210105,269,112,1489.3950337915,76,24,1427.53330484992,19,5,1630.2960388021,173,83,1489.97028686432,1,0,1619.73963885694,193,88,1610.78888382025,230,103,1393.27368084183,39,9
"berrer m",100,1476.84058138546,231,87,1491.61007113598,149,60,1435.62637062962,24,7,1443.79426035375,50,16,1506.76691137341,8,4,1446.23159873979,82,27,1475.62952138203,198,78,1418.73388616247,33,9
"berta d",101,1471.65449619068,2,0,1500,0,0,1486.51855935876,1,0,1486.20095025391,1,0,1500,0,0,1469.02374609178,2,0,1472.02973435529,2,0,1500,0,0
"bester p",102,1463.75597070861,5,0,1462.98576569349,5,0,1500,0,0,1500,0,0,1500,0,0,1500,0,0,1463.0594945565,5,0,1500,0,0
"betov s",103,1485.52918975667,1,0,1484.78422522591,1,0,1500,0,0,1500,0,0,1500,0,0,1500,0,0,1485.91661292859,1,0,1500,0,0
"bhambri y",104,1485.25552648398,14,4,1471.1653021401,14,4,1500,0,0,1500,0,0,1500,0,0,1500,0,0,1485.50887207516,12,4,1495.36643378131,2,0
"bhupathi m",105,1458.55477795925,3,0,1472.90963439048,2,0,1487.05047029068,1,0,1500,0,0,1500,0,0,1485.81696665046,1,0,1473.23782680919,2,0,1487.03431883644,1,0
"biryukov m",106,1479.40364227631,2,0,1473.64188680328,2,0,1500,0,0,1500,0,0,1500,0,0,1500,0,0,1480.25597824056,2,0,1500,0,0
"bjorkman j",107,1548.44985169632,359,177,1497.02311607803,211,100,1627.51780558432,76,50,1433.89834925211,43,12,1487.70873451827,29,15,1572.54938773957,148,77,1528.45402621806,285,136,1566.39961394342,74,41
"black b",108,1493.78777803362,74,35,1466.36052834073,48,21,1568.22360994058,19,13,1453.45183625691,6,1,1487.06662324804,1,0,1542.17230978442,26,14,1490.37793850432,59,28,1491.28144056993,15,7
"black w",109,1483.86539914296,39,15,1459.72360510591,31,12,1479.59472656616,6,2,1500,0,0,1505.0619073996,2,1,1493.80489489381,8,3,1472.87692590155,30,11,1491.87597589937,9,4
"blake j",110,1576.32934360117,567,339,1594.10795211858,410,258,1523.21716160248,56,31,1549.38133822592,79,39,1520.55088697938,22,11,1533.33078884017,157,81,1587.08550981515,464,279,1562.33196590498,103,60
"blake t",111,1471.4181090067,8,3,1483.02316580471,5,2,1499.91429368542,2,1,1487.5,1,0,1500,0,0,1486.44026065232,3,1,1470.6393519793,8,3,1500,0,0
"blanco g",112,1430.6026640825,148,58,1397.39976501763,25,5,1452.97829485925,4,0,1472.66110435759,116,53,1465.02909305885,3,0,1444.78124121803,123,53,1412.51907109149,124,49,1487.76184389392,24,9
"bloomfield r",113,1459.69595198194,16,4,1479.19607164842,2,0,1457.9748847463,14,4,1500,0,0,1500,0,0,1461.91814851399,14,4,1468.60855737404,11,3,1477.46500905425,5,1
"boeker m",114,1485.62968255731,5,1,1487.79947510862,4,1,1500,0,0,1492.97920605947,1,0,1500,0,0,1495.83013696218,1,0,1492.85228240377,4,1,1489.83598084748,1,0
"bogaerts r",115,1490.09481505112,1,0,1487.87935512539,1,0,1500,0,0,1500,0,0,1500,0,0,1500,0,0,1489.09382502499,1,0,1500,0,0
"bogdanovic a",116,1417.40739763221,37,10,1471.70106921892,5,1,1402.10297957181,32,9,1500,0,0,1500,0,0,1404.91904060333,32,9,1453.93297547777,28,10,1422.66476448466,9,0
"bogomolov a",117,1510.18733022626,155,63,1512.74707673381,122,52,1476.75872990803,23,10,1418.27315734777,10,1,1500,0,0,1437.84750830967,33,11,1519.7206440889,132,56,1452.35397615857,23,7
"bogomolov jr a",118,1467.85183556696,13,4,1457.58495773313,13,4,1500,0,0,1500,0,0,1500,0,0,1500,0,0,1501.1687969401,9,4,1453.00819611414,4,0
"bohaboy d",119,1485.99505480281,1,0,1484.92284420204,1,0,1500,0,0,1500,0,0,1500,0,0,1500,0,0,1486.16113254601,1,0,1500,0,0
"bohane a",120,1491.00923596438,1,0,1492.47675803945,1,0,1500,0,0,1500,0,0,1500,0,0,1500,0,0,1490.35888185911,1,0,1500,0,0
"bohli s",121,1402.17173659811,21,2,1419.89015388762,10,0,1487.5,1,0,1463.37342805225,6,1,1477.75832882725,4,1,1448.85139066661,11,2,1406.91301449077,20,2,1483.03808184301,1,0
"bolelli s",122,1617.61323153394,247,103,1519.82464615221,109,39,1543.02856130296,27,14,1609.87577021609,97,43,1512.20374357752,14,7,1640.89282596431,138,64,1599.61667399084,197,81,1539.46379303389,50,22
"bolt a",123,1488.36215233421,1,0,1486.06596972572,1,0,1500,0,0,1500,0,0,1500,0,0,1500,0,0,1488.41404919713,1,0,1500,0,0
"bopanna r",124,1445.79582207212,21,5,1428.98543160682,13,2,1485.02412005014,8,3,1500,0,0,1500,0,0,1491.30361258919,8,3,1440.29369573864,21,5,1500,0,0
"boruszewski j",125,1486.23291811231,1,0,1500,0,0,1487.05047029068,1,0,1500,0,0,1500,0,0,1485.84333782763,1,0,1486.59435159361,1,0,1500,0,0
"borvanov r",126,1490.23602455288,1,0,1488.36756357447,1,0,1500,0,0,1500,0,0,1500,0,0,1500,0,0,1489.45451444125,1,0,1500,0,0
"bossel a",127,1476.49756556118,2,0,1500,0,0,1476.45709000999,2,0,1500,0,0,1500,0,0,1477.17695624535,2,0,1475.16120581242,2,0,1500,0,0
"bourgeois l",128,1485.70806127737,2,0,1484.05148483399,2,0,1500,0,0,1500,0,0,1500,0,0,1500,0,0,1484.75579352892,2,0,1500,0,0
"bourgue m",129,1511.79694839989,2,1,1500,0,0,1500,0,0,1510.9476426964,2,1,1500,0,0,1511.48128408416,2,1,1500,0,0,1511.01453724878,2,1
"boutter j",130,1494.30632473466,138,60,1448.37962666715,54,20,1421.84913090261,9,1,1538.1299220876,55,29,1503.22096384018,20,10,1505.7492459381,84,40,1545.52718035531,117,56,1405.59894602657,21,4
"bower j",131,1495.76490531583,3,1,1500,0,0,1487.19300534187,3,1,1500,0,0,1500,0,0,1493.22850527302,3,1,1500,0,0,1489.25259424598,3,1
"bowles c",132,1488.49417982424,1,0,1488.28637873691,1,0,1500,0,0,1500,0,0,1500,0,0,1500,0,0,1487.57071777138,1,0,1500,0,0
"bozic i",133,1486.60660965177,1,0,1500,0,0,1500,0,0,1486.67622950858,1,0,1500,0,0,1486.67557093898,1,0,1487.07192788892,1,0,1500,0,0
"bozoljac i",134,1453.89140706431,25,8,1438.26809930449,8,1,1478.26872797684,9,3,1497.37651237507,5,2,1512.65403448327,3,2,1497.72628702529,17,7,1431.26064625673,16,4,1509.27882685744,9,4
"braasch k",135,1516.90110419895,3,2,1500,0,0,1514.12251002442,3,2,1500,0,0,1500,0,0,1516.94147344351,3,2,1517.80189846726,3,2,1500,0,0
"bracciali d",136,1507.9856504823,80,31,1452.67390182052,30,9,1514.0473624837,14,7,1513.26257062965,23,10,1477.93846679258,13,5,1516.93114603885,50,22,1512.78532585585,64,26,1449.80188863136,16,5
"braga p",137,1488.4201563899,1,0,1500,0,0,1500,0,0,1489.86574128796,1,0,1500,0,0,1489.58730260339,1,0,1488.97858148629,1,0,1500,0,0
"brands d",138,1538.00778887294,143,56,1514.00364615647,75,28,1494.55694395791,15,7,1521.57346915792,53,21,1500,0,0,1519.52810988351,68,28,1547.65026225059,119,49,1453.51682400952,24,7
"brasington j",139,1449.40760494703,10,2,1460.39706552697,6,1,1486.37537632024,1,0,1488.34235408493,3,1,1500,0,0,1473.11665095611,4,1,1484.43243488179,2,0,1450.94509520442,8,2
"breen m",140,1485.99593942127,1,0,1486.13270745657,1,0,1500,0,0,1500,0,0,1500,0,0,1500,0,0,1500,0,0,1486.6181929939,1,0
"britton d",141,1483.58140341997,3,0,1479.09465480802,3,0,1500,0,0,1500,0,0,1500,0,0,1500,0,0,1483.29806536947,2,0,1499.13209787785,1,0
"brizzi a",142,1486.11879694404,1,0,1500,0,0,1500,0,0,1486.67230809597,1,0,1500,0,0,1486.37352218868,1,0,1485.8823942908,1,0,1500,0,0
"broady l",143,1487.92409081804,5,1,1500,0,0,1470.89615311609,5,1,1500,0,0,1500,0,0,1477.57917449113,5,1,1477.49642135625,2,0,1497.92048336426,3,1
"brown d",144,1661.89130525799,121,50,1529.71651784303,49,18,1531.58212387758,32,14,1544.18187628588,40,18,1500,0,0,1603.30641522472,72,32,1640.26284841414,99,43,1478.59930060324,22,7
"browne f",145,1459.01384486071,28,11,1478.46802632978,6,2,1500,0,0,1466.0980446879,22,9,1500,0,0,1463.0050759366,22,9,1451.69356293513,24,9,1499.47437379476,4,2
"bruguera s",146,1463.74678874956,72,33,1455.2076455944,10,3,1486.61928929314,1,0,1509.28162133269,59,29,1499.53712018102,2,1,1492.39585807505,62,30,1492.4846861735,66,32,1451.45508586139,6,1
"brugues davi a",147,1490.75093904847,4,1,1501.57101661771,3,1,1500,0,0,1487.22233788646,1,0,1500,0,0,1487.28092448916,1,0,1495.89930602931,3,1,1492.04565143265,1,0
"bryan b",148,1446.81900463673,40,13,1444.99453400254,21,5,1518.89567005005,14,8,1459.81541201295,4,0,1487.06668960131,1,0,1471.75353972473,19,8,1444.6296899085,36,12,1480.75290851847,4,1
"bryan m",149,1484.18779821905,13,5,1500.27600725658,9,4,1479.3019433043,4,1,1500,0,0,1500,0,0,1476.0034198309,4,1,1489.04514026303,12,5,1494.29229946826,1,0
"brzezicki j p",150,1452.26242811351,23,7,1465.28666782403,3,0,1500,0,0,1481.0181664817,20,7,1500,0,0,1477.2550043748,20,7,1456.5490697897,17,5,1482.82819874994,6,2
"bubka s",151,1494.86033468357,17,5,1495.47004508161,13,4,1487.71734862895,3,1,1491.7446529405,1,0,1500,0,0,1481.19201981717,4,1,1486.07407977971,15,4,1508.16272034105,2,1
"bublik a",152,1513.1424577652,4,2,1508.23535157072,4,2,1500,0,0,1500,0,0,1500,0,0,1500,0,0,1511.75153580543,4,2,1500,0,0
"buchanan c",153,1487.4952611298,2,0,1486.88655883979,2,0,1500,0,0,1500,0,0,1500,0,0,1500,0,0,1490.32229343099,1,0,1492.66377033131,1,0
"burgsmuller l",154,1391.23654048778,178,63,1423.33715452388,101,39,1448.73670883106,23,8,1406.09474913506,47,14,1462.70599062227,7,2,1381.19124482046,77,24,1375.92610337302,146,52,1445.72007409043,32,11
"burniol g",155,1477.25849673541,2,0,1500,0,0,1500,0,0,1476.55787394661,2,0,1500,0,0,1479.58372515806,2,0,1476.22862545822,2,0,1500,0,0
"burquier g",156,1492.32114124844,1,0,1485.74565714357,1,0,1500,0,0,1500,0,0,1500,0,0,1500,0,0,1492.07202540647,1,0,1500,0,0
"burrieza o",157,1469.56038552406,5,1,1500,0,0,1487.05047029068,3,1,1476.53957173515,2,0,1500,0,0,1465.40073197485,5,1,1467.78023470985,5,1,1500,0,0
"cabal j s",158,1476.42945607259,2,0,1500,0,0,1500,0,0,1474.8659147822,2,0,1500,0,0,1474.98997022154,2,0,1476.79958041422,2,0,1500,0,0
"cabello f",159,1485.74913767491,1,0,1500,0,0,1500,0,0,1486.99643150406,1,0,1500,0,0,1486.70056587855,1,0,1486.10353637997,1,0,1500,0,0
"cachin p",160,1489.86760522144,1,0,1500,0,0,1500,0,0,1488.46097139221,1,0,1500,0,0,1491.04015769981,1,0,1490.29653092322,1,0,1500,0,0
"cacic n",161,1507.21372508657,2,1,1500,0,0,1500,0,0,1503.69407153471,2,1,1500,0,0,1503.91294795328,2,1,1504.78702058291,2,1,1500,0,0
"cadart r",162,1472.67048096379,7,2,1505.89297033439,4,2,1485.57420210951,1,0,1486.79775724438,1,0,1488.60154059005,1,0,1464.40740462458,3,0,1481.56774584005,6,2,1487.5,1,0
"cakl t",163,1457.48892978802,12,3,1446.1281715999,7,1,1500,0,0,1499.36238555012,2,1,1494.90590313409,3,1,1499.59695475068,5,2,1456.4174337531,12,3,1500,0,0
"calatrava a",164,1402.35130464848,133,54,1429.28065110601,50,20,1465.82269961168,5,1,1433.22121252491,77,33,1487.5,1,0,1424.28724305141,83,34,1393.13350463504,115,47,1472.28165901387,18,7
"caldwell d",165,1486.98631595699,1,0,1487.5,1,0,1500,0,0,1500,0,0,1500,0,0,1500,0,0,1487.00184355276,1,0,1500,0,0
"calleri a",166,1517.13769213733,373,195,1519.03830048331,136,61,1447.71503671198,14,4,1572.90154056387,209,124,1475.97961200069,14,6,1530.69771300511,237,134,1540.11685282718,322,177,1422.56471482073,51,18
"canas g",167,1542.20410578131,362,218,1623.98298195581,145,89,1574.69910856626,35,22,1615.78152685992,165,100,1467.17819991497,17,7,1563.27541379714,217,129,1554.85954646035,294,181,1557.8913292324,68,37
"capalik k",168,1469.98085926993,8,3,1483.93001241513,3,1,1501.07455327042,4,2,1487.94452789918,1,0,1500,0,0,1489.75503686931,5,2,1470.26260701884,8,3,1500,0,0
"capdeville p",169,1417.17777976135,102,35,1452.35363520961,54,20,1440.05499486304,9,2,1443.31003895422,39,13,1500,0,0,1406.15632656571,48,15,1418.2250649252,84,28,1472.7031247563,18,7
"caratti c",170,1407.57188830634,13,2,1435.8164807927,7,1,1464.82035319984,5,1,1500,0,0,1487.5,1,0,1449.47429398356,6,1,1427.53022867705,11,2,1472.63454825927,2,0
"carballes baena r",171,1499.15636518769,25,10,1489.67205364755,1,0,1500,0,0,1496.27953656865,24,10,1500,0,0,1493.73580832438,24,10,1504.78790105942,24,10,1487.5,1,0
"carlsen k",172,1511.89047431967,189,82,1522.47992401335,126,58,1479.31279681028,32,15,1396.29684133468,18,3,1499.41107762359,13,6,1451.75276906364,63,24,1521.64142473153,165,77,1393.31365603883,24,5
"carlson a",173,1486.34967746328,1,0,1486.93469325497,1,0,1500,0,0,1500,0,0,1500,0,0,1500,0,0,1486.55374222626,1,0,1500,0,0
"carraz g",174,1471.07756786744,82,34,1489.58667076359,52,22,1484.2992341443,15,6,1469.35403981339,4,1,1489.81105677716,11,5,1469.81471341894,30,12,1461.02599412697,70,29,1494.02795789889,12,5
"carreno busta p",175,1762.32664971481,158,74,1665.8408329412,67,32,1458.8829457883,5,0,1642.55790594457,86,42,1500,0,0,1625.31100489997,91,42,1740.0931844033,138,67,1508.52083430602,20,7
"carretero r",176,1497.30138755993,4,2,1500,0,0,1500,0,0,1498.74333997102,4,2,1500,0,0,1497.75224221373,4,2,1499.38794282761,4,2,1500,0,0
"caruso s",177,1497.14587503399,1,0,1500,0,0,1500,0,0,1491.77930866394,1,0,1500,0,0,1493.63461829319,1,0,1495.90164316143,1,0,1500,0,0
"cecchinato m",178,1424.1267356594,20,2,1461.93153509073,4,0,1500,0,0,1427.62568146197,16,2,1500,0,0,1432.73115942982,16,2,1430.66680590286,17,2,1473.733082021,3,0
"cermak f",179,1471.75540793662,24,9,1462.82850354008,3,0,1502.57793004165,2,1,1506.30895637807,19,8,1500,0,0,1503.0755724779,21,9,1468.61493734178,24,9,1500,0,0
"cervantes i",180,1489.61709817102,48,17,1487.80065228827,13,4,1484.4407486273,4,1,1478.06976361123,31,12,1500,0,0,1467.60260146954,35,13,1488.68868694193,42,16,1473.69712996275,6,1
"cervenak p",181,1531.96320327695,9,5,1500,0,0,1500,0,0,1529.28210986338,8,5,1486.3757060023,1,0,1527.06263318865,9,5,1530.21656284278,9,5,1500,0,0
"chadaj a",182,1500.93478123702,2,1,1500,0,0,1500,0,0,1501.66478449604,2,1,1500,0,0,1500.63567124948,2,1,1500.22502032015,2,1,1500,0,0
"chaen t",183,1485.2889579935,1,0,1484.6606896218,1,0,1500,0,0,1500,0,0,1500,0,0,1500,0,0,1485.64795054967,1,0,1500,0,0
"chaki r",184,1481.41618718513,2,0,1500,0,0,1500,0,0,1481.02895711274,2,0,1500,0,0,1480.35773716688,2,0,1481.01455342456,2,0,1500,0,0
"chang m",185,1459.44970082666,141,67,1457.61005212806,95,45,1512.33475586707,17,9,1477.66533648252,25,11,1501.63271005524,4,2,1475.92803241158,46,22,1474.86926093029,119,59,1445.46820109706,22,8
"chardy j",186,1598.06899681684,409,201,1576.12557755511,216,103,1523.68140543963,37,17,1612.06631851836,150,78,1503.70036094567,6,3,1606.01255577318,193,98,1551.64418752436,330,156,1661.49972413602,79,45
"charpentier m",187,1442.24823604494,8,1,1500,0,0,1500,0,0,1448.25755164347,7,1,1492.05262887145,1,0,1440.5522189802,8,1,1437.11988729711,6,0,1499.79140148266,2,1
"chekov p",188,1485.21341624685,1,0,1500,0,0,1500,0,0,1500,0,0,1486.90233865194,1,0,1485.71550959742,1,0,1484.79224229666,1,0,1500,0,0
"chela j",189,1518.12850918533,570,305,1496.11533013479,233,119,1431.28181286316,15,4,1586.32000369773,310,180,1426.46120758742,12,2,1565.66707321474,337,186,1514.61990388977,481,259,1540.6522899707,89,46
"chen t",190,1474.70295923118,3,0,1474.26252835056,3,0,1500,0,0,1500,0,0,1500,0,0,1500,0,0,1474.0923737001,3,0,1500,0,0
"cherkasov a",191,1474.53687597421,4,1,1486.635633964,3,1,1500,0,0,1500,0,0,1487.5,1,0,1487.95675287176,1,0,1474.52072766726,4,1,1500,0,0
"childs l",192,1443.6739765332,10,2,1498.83729298357,2,1,1436.37903409395,8,1,1500,0,0,1500,0,0,1441.64260873032,8,1,1465.33837151768,5,1,1467.65715175417,5,1
"chiudinelli m",193,1489.38434054786,125,44,1466.76458607278,85,30,1490.10107184514,14,6,1467.3914930431,21,7,1463.60395912992,5,1,1467.13353744938,40,14,1476.85303715951,108,36,1507.69337702725,17,8
"choinski j",194,1490.39963011046,1,0,1500,0,0,1488.05569199045,1,0,1500,0,0,1500,0,0,1488.04351405733,1,0,1489.93431300905,1,0,1500,0,0
"chung h",195,1524.73804299232,38,15,1521.69843560881,25,10,1486.82423534489,3,1,1492.03593753793,10,4,1500,0,0,1485.45404798775,13,5,1525.23160584459,33,14,1483.54027796617,5,1
"chvojka e",196,1482.38511512771,2,0,1493.47779905825,1,0,1500,0,0,1489.64686857601,1,0,1500,0,0,1488.93772248168,1,0,1481.99504440629,2,0,1500,0,0
"cilic m",197,1929.9753582129,562,364,1871.69848402308,336,224,1734.94365506341,67,46,1711.03372878645,138,81,1573.4311018843,21,13,1784.76085153287,226,140,1890.37486969609,445,281,1821.71303033923,117,83
"ciorcila p",198,1489.60016642327,1,0,1500,0,0,1500,0,0,1485.71516028876,1,0,1500,0,0,1487.05810835366,1,0,1489.38219195132,1,0,1500,0,0
"cipolla f",199,1454.80629984453,101,35,1468.84440570061,55,21,1438.07766160483,8,1,1451.49237115874,38,13,1500,0,0,1433.30514407944,46,14,1457.31251249395,82,28,1479.13934084219,19,7
"clavet f",200,1454.4992269841,147,64,1509.77858217825,77,36,1490.68542363715,7,3,1412.82267527403,60,25,1464.39961716011,3,0,1385.15793945063,70,28,1468.72443449101,127,57,1442.31518911548,20,7
"clayton a",201,1485.79069470597,1,0,1486.21571071788,1,0,1500,0,0,1500,0,0,1500,0,0,1500,0,0,1485.42051199505,1,0,1500,0,0
"clemens t",202,1505.32543305944,4,2,1512.39777835894,3,2,1500,0,0,1500,0,0,1487.5,1,0,1487.57070485325,1,0,1503.90617298095,4,2,1500,0,0
"clement a",203,1538.38869169349,506,253,1516.37426658857,290,148,1526.40418540312,80,44,1472.25844726604,80,31,1496.35080477428,56,30,1499.98932498233,216,105,1528.07035765851,407,199,1505.9144464379,99,54
"clezar g",204,1415.89092661262,9,0,1486.21910873223,1,0,1500,0,0,1429.48296137362,8,0,1500,0,0,1428.11019104493,8,0,1426.6066658396,8,0,1487.77827013606,1,0
"cobolli s",205,1489.34046019941,1,0,1500,0,0,1500,0,0,1490.29772565237,1,0,1500,0,0,1489.66751285206,1,0,1488.90921511698,1,0,1500,0,0
"coetzee j",206,1489.33307729721,1,0,1500,0,0,1487.1085889547,1,0,1500,0,0,1500,0,0,1487.04220520731,1,0,1489.29573250361,1,0,1500,0,0
"condor f",207,1486.58301530573,1,0,1500,0,0,1500,0,0,1483.05831276783,1,0,1500,0,0,1483.55029555563,1,0,1487.04973709627,1,0,1500,0,0
"cook l",208,1486.94561232886,1,0,1486.40298083299,1,0,1500,0,0,1500,0,0,1500,0,0,1500,0,0,1486.6735920857,1,0,1500,0,0
"copil m",209,1558.10795409958,45,18,1554.93970175112,22,10,1485.19834747772,7,3,1466.23611255371,16,5,1500,0,0,1472.570075466,23,8,1542.74320271054,42,17,1492.69225995043,3,1
"coppejans k",210,1466.28424839657,4,0,1500,0,0,1492.25702615948,1,0,1471.44706557723,3,0,1500,0,0,1468.49818201322,4,0,1476.37782323313,3,0,1484.68364948968,1,0
"coria g",211,1528.72765137086,321,210,1637.97822813703,114,66,1540.19991179466,16,9,1601.48480248056,182,129,1529.97756622091,9,6,1565.995658636,207,144,1537.58933625475,253,166,1641.997518792,68,44
"coric b",212,1684.015590496,103,50,1633.48952703056,61,29,1481.37939244653,7,2,1584.28794504103,35,19,1500,0,0,1572.65105526543,42,21,1681.91255802894,88,44,1501.96277308615,15,6
"corretja a",213,1479.70605595121,239,138,1545.25685500758,108,60,1477.5646806819,2,0,1503.80286748715,118,75,1450.42773821202,11,3,1468.06815467702,131,78,1472.13354198022,194,108,1585.99366457808,45,30
"corrie e",214,1489.2051800518,1,0,1500,0,0,1487.35493119623,1,0,1500,0,0,1500,0,0,1487.04687308476,1,0,1489.1713361413,1,0,1500,0,0
"cortes j",215,1489.34412804458,1,0,1500,0,0,1500,0,0,1490.03380633673,1,0,1500,0,0,1490.03380633673,1,0,1489.63728893529,1,0,1500,0,0
"costa a",216,1551.53133594995,271,144,1512.31982323107,104,47,1486.59033155939,1,0,1575.19236976927,151,91,1469.97517875716,15,6,1560.92024856162,167,97,1555.95814423646,221,113,1580.95103139468,50,31
"costa f",217,1453.53584227852,4,0,1475.37197096268,2,0,1500,0,0,1475.46916770222,2,0,1500,0,0,1475.42214282843,2,0,1452.57695527316,4,0,1500,0,0
"courier j",218,1490.9139660001,9,4,1491.2979876858,9,4,1500,0,0,1500,0,0,1500,0,0,1500,0,0,1500.52340321859,8,4,1487.5,1,0
"coutelot n",219,1486.12832434181,32,13,1483.86789020398,2,0,1475.26401998934,2,0,1505.61027588943,28,13,1500,0,0,1485.47767647971,30,13,1454.6167096228,22,8,1517.06076682798,10,5
"couto e",220,1486.06892898363,1,0,1500,0,0,1500,0,0,1486.51568839184,1,0,1500,0,0,1486.17067064664,1,0,1485.20183367438,1,0,1500,0,0
"cowan b",221,1448.74881733714,16,5,1463.89063229949,7,2,1472.08201007153,9,3,1500,0,0,1500,0,0,1473.40296682425,9,3,1455.39926159019,10,3,1483.14568102515,6,2
"cox d",222,1448.85579101757,5,0,1500,0,0,1442.41302651209,5,0,1500,0,0,1500,0,0,1445.67317670391,5,0,1458.83673688755,3,0,1479.97357001675,2,0
"crabb j",223,1444.7567885197,8,1,1441.77377633437,8,1,1500,0,0,1500,0,0,1500,0,0,1500,0,0,1446.74000092609,5,0,1490.66538605965,3,1
"craca m",224,1486.07384054679,1,0,1500,0,0,1500,0,0,1485.80432561013,1,0,1500,0,0,1485.65177793257,1,0,1486.51613081183,1,0,1500,0,0
"crivoi v",225,1419.5599169314,41,12,1460.06853794152,9,2,1482.25399995697,3,1,1435.28210685715,29,9,1500,0,0,1427.47166171293,32,10,1422.52748471141,35,10,1483.38754214146,6,2
"cruciat a",226,1487.71432543542,3,1,1500,0,0,1500,0,0,1489.50830006964,3,1,1500,0,0,1487.54859727175,3,1,1489.15101893768,3,1,1500,0,0
"crugnola m",227,1485.15802856372,3,0,1486.32853277575,2,0,1500,0,0,1494.52117294724,1,0,1500,0,0,1494.44494026976,1,0,1487.8072106644,2,0,1495.12139819356,1,0
"cuadrado c",228,1510.39151224759,8,4,1500,0,0,1500,0,0,1510.44123968726,8,4,1500,0,0,1509.99029185727,8,4,1511.7746707077,8,4,1500,0,0
"cuevas p",229,1674.43446129095,264,136,1523.88466764058,93,38,1505.02510071096,13,6,1751.42583158586,158,92,1500,0,0,1727.78384551517,171,98,1680.70924791729,229,124,1473.11251251163,35,12
"dabrowski b",230,1490.71600878006,2,0,1500,0,0,1500,0,0,1487.99055099609,2,0,1500,0,0,1489.42195671798,2,0,1487.80930182474,2,0,1500,0,0
"dabul b",231,1462.29563206397,42,15,1483.11735881445,15,5,1491.39675183528,7,3,1458.52820676978,20,7,1500,0,0,1459.99624137908,27,10,1481.53691588504,34,14,1447.22216728142,8,1
"dailey z",232,1490.10799272225,1,0,1489.30425136611,1,0,1500,0,0,1500,0,0,1500,0,0,1500,0,0,1489.78307155565,1,0,1500,0,0
"damm m",233,1420.05525809393,42,16,1440.34077611796,21,7,1497.39008376095,12,6,1481.33585300854,8,3,1487.5,1,0,1465.44843137731,21,9,1449.15940032505,32,14,1439.11639624196,10,2
"dancevic f",234,1482.22902443462,139,52,1431.22366553438,89,31,1506.03588900318,42,20,1453.47084789714,4,0,1481.07000050483,4,1,1487.62183908201,50,21,1510.28428697146,115,47,1407.61126786453,24,5
"daniel m",235,1381.03909580499,83,20,1352.3625168052,22,1,1453.84646373295,7,1,1461.9434173569,54,18,1500,0,0,1443.04980128517,61,19,1411.07796571941,66,19,1382.41201362029,17,1
"daniel t",236,1463.66073925342,33,9,1458.58889681689,11,2,1486.69084829833,1,0,1482.16894134269,21,7,1500,0,0,1478.76308653511,22,7,1458.87445700109,27,8,1475.80533645517,6,1
"darcis s",237,1580.74329018482,162,72,1556.29845358094,84,38,1530.69600866212,21,10,1500.65606014437,54,22,1518.6279291886,3,2,1539.1940547757,78,34,1576.23829657618,126,60,1486.93785157563,36,12
"dasnieres de veigy j",238,1474.28412685076,6,1,1484.00337541115,2,0,1500,0,0,1485.37303535991,4,1,1500,0,0,1484.91262488449,4,1,1488.65015992021,4,1,1487.21715022213,2,0
"davletshin v",239,1478.18340870764,2,0,1488.19510765089,1,0,1500,0,0,1500,0,0,1488.42539631295,1,0,1491.64166376532,1,0,1477.88253698275,2,0,1500,0,0
"davydenko n",240,1596.25038759704,783,467,1653.27093986806,408,240,1451.38987490678,28,9,1551.23273993055,291,180,1680.93157452746,56,38,1543.09105254397,375,227,1598.45536000125,650,384,1623.10630038578,133,83
"davydenko p",241,1495.90166554674,3,1,1489.65837919634,1,0,1500,0,0,1505.12054887339,2,1,1500,0,0,1505.2578314706,2,1,1495.32773622563,3,1,1500,0,0
"de bakker t",242,1520.8464861305,131,53,1493.66092581689,69,26,1475.59428934637,16,6,1531.28143036008,46,21,1500,0,0,1516.82802312795,62,27,1531.46279292552,112,47,1471.39222817846,19,6
"de chaunac s",243,1482.58889554156,32,10,1485.68659585895,26,9,1500,0,0,1481.85766885121,4,1,1475.0228340532,2,0,1465.3247924798,6,1,1471.9539238184,26,8,1487.84386185238,6,2
"de greef a",244,1501.96425689052,2,1,1500,0,0,1500,0,0,1498.64636716597,2,1,1500,0,0,1497.81736404628,2,1,1502.34331798268,2,1,1500,0,0
"de heart r",245,1504.1175057326,3,1,1503.18832898003,3,1,1500,0,0,1500,0,0,1500,0,0,1500,0,0,1489.83879915179,1,0,1511.0712602212,2,1
"de loore j",246,1489.0245316127,1,0,1488.63827139117,1,0,1500,0,0,1500,0,0,1500,0,0,1500,0,0,1489.20782422693,1,0,1500,0,0
"de paula f",247,1486.99773841893,1,0,1500,0,0,1500,0,0,1487.05047029068,1,0,1500,0,0,1486.82611840459,1,0,1486.37846681242,1,0,1500,0,0
"de schepper k",248,1406.79964163875,76,21,1426.71442815949,32,8,1482.91778044212,20,8,1404.2850212339,24,5,1500,0,0,1415.8463953332,44,13,1400.14725551225,57,15,1463.07566985519,19,6
"de voest r",249,1436.09748758985,57,19,1432.48609869528,44,15,1458.29782311404,11,3,1500,0,0,1496.04138544004,2,1,1466.07910017304,13,4,1454.8091390099,48,17,1457.8723839311,9,2
"decoud s",250,1522.13237600163,8,4,1500,0,0,1488.74914431181,1,0,1537.83241776943,7,4,1500,0,0,1519.41707331498,8,4,1514.78902023273,6,3,1498.97350479189,2,1
"deen heshaam a",251,1488.12242762582,1,0,1487.79336345261,1,0,1500,0,0,1500,0,0,1500,0,0,1500,0,0,1488.22991132929,1,0,1500,0,0
"deheart r",252,1486.25133843902,2,0,1485.48718666003,2,0,1500,0,0,1500,0,0,1500,0,0,1500,0,0,1485.93994535147,2,0,1500,0,0
"del bonis f",253,1529.15214524268,13,6,1486.0426648359,1,0,1500,0,0,1540.68308643601,12,6,1500,0,0,1537.6322175733,12,6,1530.29185021932,13,6,1500,0,0
"del potro j",254,1927.7701681683,452,318,1905.97877878329,315,224,1664.66895536268,43,29,1803.08050463254,81,57,1553.61265929193,13,8,1836.18664698507,137,94,1899.99399004203,355,249,1810.6179595876,97,69
"delbonis f",255,1594.70189921895,156,74,1476.74133730766,53,17,1446.52341112259,5,0,1656.80167618121,98,57,1500,0,0,1640.55279347502,103,57,1598.92074981129,138,69,1453.7948352025,18,5
"delfino m",256,1487.69102519447,1,0,1500,0,0,1500,0,0,1487.00792035089,1,0,1500,0,0,1487.2733181296,1,0,1500,0,0,1486.78681543266,1,0
"delgado j",257,1398.77108099453,37,10,1429.82407945145,15,4,1428.94726959239,21,6,1490.72763614124,1,0,1500,0,0,1438.41954111688,22,6,1410.20951000573,26,8,1452.2577008074,11,2
"delgado r",258,1472.79025337168,83,32,1471.16967191692,61,24,1460.00243214168,6,1,1492.11279659467,16,7,1500,0,0,1456.94480944354,22,8,1469.86305276926,68,26,1482.32736444972,15,6
"delic a",259,1491.02312769625,76,25,1506.61777893038,60,22,1472.15695766928,8,2,1459.18892177582,7,1,1487.5,1,0,1424.90262425087,16,3,1449.77004756462,59,18,1508.33842356865,17,7
"delic m",260,1461.66447012616,10,2,1486.6860511708,2,0,1500,0,0,1465.73536646732,8,2,1500,0,0,1465.93338147818,8,2,1460.57819788459,10,2,1500,0,0
"dell acqua m",261,1477.30588043999,6,1,1478.66534522428,2,0,1500.21692299988,2,1,1484.74131694378,2,0,1500,0,0,1494.63249205079,4,1,1476.7580646358,6,1,1500,0,0
"demoliner m",262,1499.70488424746,2,1,1500,0,0,1500,0,0,1496.89963910919,2,1,1500,0,0,1496.61963367618,2,1,1499.8617207,2,1,1500,0,0
"dent t",263,1584.74750441501,280,146,1584.0270849725,203,107,1540.08154773084,51,29,1446.28669053874,16,4,1525.90910781207,10,6,1521.87295631966,77,39,1551.94069968844,228,119,1568.57090840718,52,27
"derepasko a",264,1493.65899555393,1,0,1500,0,0,1489.01494813735,1,0,1500,0,0,1500,0,0,1490.474868292,1,0,1500,0,0,1490.89034266623,1,0
"desein n",265,1469.27636568349,3,0,1489.41509209682,1,0,1486.24043957171,1,0,1488.69909669181,1,0,1500,0,0,1473.98424625361,2,0,1477.88181914055,2,0,1488.05404675266,1,0
"dev varman s",266,1464.02230714547,3,0,1466.21129750764,3,0,1500,0,0,1500,0,0,1500,0,0,1500,0,0,1464.88039264431,3,0,1500,0,0
"devilder n",267,1445.24576819149,70,23,1438.74703307743,19,5,1481.99301717544,6,2,1469.60910373558,43,16,1474.42434484762,2,0,1450.32918193086,51,18,1400.70602889047,54,17,1487.48761558518,16,6
"devvarman s",268,1478.06214300537,114,48,1515.47277752708,85,39,1464.67620652071,10,3,1464.20326413197,19,6,1500,0,0,1440.08961666972,29,9,1501.3047121746,95,43,1443.14189595772,19,5
"dewulf f",269,1476.79914190001,4,1,1489.22849795456,3,1,1500,0,0,1487.13077879029,1,0,1500,0,0,1487.13077879029,1,0,1476.44728737695,4,1,1500,0,0
"di mauro a",270,1428.63076539624,51,15,1483.54962593611,4,1,1486.11059814343,3,1,1423.69429274336,44,13,1500,0,0,1418.82857233102,47,14,1437.2626194075,43,13,1458.88846710388,8,2
"di pasquale a",271,1409.73516853002,90,29,1407.26746593737,31,8,1500,2,1,1428.17575108691,55,20,1474.56664341302,2,0,1420.87014739202,59,21,1402.09885279346,75,24,1465.55489261969,15,5
"diaz j",272,1368.40937943264,43,10,1392.62715903344,18,3,1487.93810396903,1,0,1433.36421155344,24,7,1500,0,0,1422.17679796963,25,7,1390.20748025168,33,8,1439.09589615944,10,2
"diez s",273,1473.75236048321,5,1,1494.0283064073,3,1,1500,0,0,1474.52596558334,2,0,1500,0,0,1474.66412727107,2,0,1473.59731538098,5,1,1500,0,0
"dimitrov g",274,1816.56668717319,338,199,1798.84301900635,215,125,1618.62350106006,45,27,1692.9064366489,78,47,1500,0,0,1712.90364323332,123,74,1790.26486435905,280,166,1657.99776647546,58,33
"djere l",275,1472.26262875367,3,0,1492.8694072765,1,0,1500,0,0,1477.26525935526,2,0,1500,0,0,1477.19092651046,2,0,1483.16766518555,2,0,1486.32683580747,1,0
"djokovic m",276,1453.42999510755,4,0,1478.59535153081,2,0,1500,0,0,1473.85933462747,2,0,1500,0,0,1473.23490536046,2,0,1452.73736835726,4,0,1500,0,0
"djokovic n",277,2265.59725796448,857,714,2224.10511118801,559,475,1898.61286459636,79,65,2127.41932037193,206,167,1512.57437303254,13,7,2157.94672071547,298,239,2228.76887233034,592,486,2147.0012848462,265,228
"dlouhy l",278,1443.72081155157,66,19,1416.65465827698,18,3,1468.30995685469,7,2,1474.48967642774,32,11,1472.29666828049,9,3,1445.72904005614,48,16,1432.84589921982,52,14,1471.56023316454,14,5
"do m q",279,1485.57553229764,1,0,1487.24507846375,1,0,1500,0,0,1500,0,0,1500,0,0,1500,0,0,1485.21616929053,1,0,1500,0,0
"dodig i",280,1513.25826477598,240,112,1477.80685697966,154,71,1564.1661116834,30,17,1556.18941226017,53,22,1516.83576287456,3,2,1593.84060751784,86,41,1537.30791138668,201,97,1498.04020117282,39,15
"dolgopolov a",281,1477.08994752468,2,0,1500,0,0,1500,0,0,1478.68410998511,2,0,1500,0,0,1476.06310231157,2,0,1477.92451751562,2,0,1500,0,0
"dolgopolov o",282,1630.20251637027,351,183,1603.6678609472,214,112,1567.87733176448,39,22,1619.67433685382,98,49,1500,0,0,1642.72679180635,137,71,1642.09575712803,299,156,1541.98557254376,52,27
"donaldson j",283,1542.56916615268,30,11,1528.1001411201,26,10,1476.10530940897,4,1,1500,0,0,1500,0,0,1478.32253467813,4,1,1510.21491563955,25,9,1507.34883961456,5,2
"donati m",284,1515.0275530126,2,1,1500,0,0,1500,0,0,1513.61332195247,2,1,1500,0,0,1514.06430156479,2,1,1514.53316252416,2,1,1500,0,0
"donskoy e",285,1456.64650437646,87,26,1469.48414258483,57,20,1477.07761675643,9,3,1388.86015451356,20,3,1487.06737701179,1,0,1396.35482547813,30,6,1433.69262974594,69,19,1497.94045261996,18,7
"dorsch b",286,1472.27199493608,3,0,1479.78888368807,2,0,1489.23252663341,1,0,1500,0,0,1500,0,0,1489.85044059828,1,0,1479.51034603302,2,0,1491.40987637143,1,0
"dosedel s",287,1421.65254706722,58,22,1458.48036789507,30,12,1504.8401574747,4,2,1439.99066466101,23,8,1487.5,1,0,1434.59568023817,28,10,1407.53558830664,42,14,1497.40637696772,16,8
"draper s",288,1504.08938110087,54,19,1517.86072059932,35,14,1459.94344435097,14,5,1454.80804591126,5,0,1500,0,0,1441.67500881327,19,5,1526.78275142398,37,16,1419.61022326631,17,3
"dreekmann h",289,1489.59920402505,2,0,1500,0,0,1477.24284340865,2,0,1500,0,0,1500,0,0,1484.92206591657,2,0,1488.5755555357,2,0,1500,0,0
"duckworth j",290,1505.5442115979,55,19,1503.37797247893,40,14,1480.5542815078,7,2,1479.37645085691,8,3,1500,0,0,1466.48908370048,15,5,1519.85079866963,36,14,1447.13371153371,19,5
"duclos p l",291,1496.61868262547,4,1,1491.59282739893,3,1,1491.58638238991,1,0,1500,0,0,1500,0,0,1498.42021256977,1,0,1492.99460397037,4,1,1500,0,0
"dupre t",292,1486.58722347525,1,0,1487.09422415995,1,0,1500,0,0,1500,0,0,1500,0,0,1500,0,0,1486.54463950358,1,0,1500,0,0
"dupuis a",293,1525.63489817567,193,77,1424.47750206469,84,31,1536.23986690191,39,19,1434.67178016312,57,21,1506.91840061385,13,6,1529.36585120889,109,46,1543.40356240852,165,69,1406.96897702707,28,8
"durek r",294,1488.938388985,1,0,1488.05942083213,1,0,1500,0,0,1500,0,0,1500,0,0,1500,0,0,1488.5745978726,1,0,1500,0,0
"dustov f",295,1448.45617521331,7,0,1500,0,0,1478.02338396731,2,0,1453.40697878764,5,0,1500,0,0,1441.25769263891,7,0,1446.72408056983,7,0,1500,0,0
"dutra da silva r",296,1503.14373326419,2,1,1501.75952787207,2,1,1500,0,0,1500,0,0,1500,0,0,1500,0,0,1500,0,0,1499.29858536629,2,1
"dutra silva r",297,1425.72999308925,32,7,1511.38003910546,6,2,1463.40207959289,3,0,1417.85105742699,23,5,1500,0,0,1402.60651258836,26,5,1422.697270336,22,5,1474.11760076879,10,2
"dzumhur d",298,1598.18248586599,63,29,1546.95263590239,33,14,1501.71254157255,5,2,1559.36628380658,25,13,1500,0,0,1559.07203212612,30,15,1581.20338549324,46,22,1518.87312327391,17,7
"eagle j",299,1489.10246764026,1,0,1488.05562443818,1,0,1500,0,0,1500,0,0,1500,0,0,1500,0,0,1489.03117500141,1,0,1500,0,0
"eaton c",300,1504.14027452995,2,1,1500,0,0,1502.98713140109,2,1,1500,0,0,1500,0,0,1499.99447856827,2,1,1500,0,0,1501.36223995183,2,1
"ebden m",301,1381.39796338726,113,36,1406.16801874859,81,29,1441.57190214769,20,6,1412.40631591784,12,1,1500,0,0,1397.36993920745,32,7,1370.74760937329,93,31,1433.64467976639,20,5
"ebelthite c",302,1487.52675618446,1,0,1487.64961204873,1,0,1500,0,0,1500,0,0,1500,0,0,1500,0,0,1500,0,0,1487.65760898795,1,0
"echagaray b",303,1469.14233976976,4,0,1492.67744357738,1,0,1500,0,0,1478.41466452289,3,0,1500,0,0,1476.35130247423,3,0,1476.04116920038,3,0,1488.61189567257,1,0
"economidis k",304,1410.92062614635,12,1,1437.81153844695,6,0,1467.47960915673,3,0,1496.1211113271,3,1,1500,0,0,1462.96299320406,6,1,1417.89435059424,7,0,1475.96435473665,5,1
"edmund k",305,1625.62533480248,50,20,1589.35854915809,29,13,1449.8478024251,13,3,1515.2551976887,8,4,1500,0,0,1491.48460198547,21,7,1583.12537684791,37,15,1508.92799397929,13,5
"ehrat s",306,1483.73451574483,1,0,1500,0,0,1500,0,0,1484.95342850014,1,0,1500,0,0,1484.91370837494,1,0,1484.08586456332,1,0,1500,0,0
"eitzinger r",307,1496.22813476517,9,3,1492.36632202116,3,1,1500,0,0,1492.64911121344,6,2,1500,0,0,1494.99576875024,6,2,1495.57447257637,9,3,1500,0,0
"el aarej m",308,1447.0194701846,7,1,1500,0,0,1500,0,0,1447.81607196619,7,1,1500,0,0,1448.08617845643,7,1,1447.51067693491,7,1,1500,0,0
"el amrani r",309,1471.58194862357,7,2,1488.34316023413,1,0,1500,0,0,1482.79406616731,6,2,1500,0,0,1480.64438001031,6,2,1469.76314489587,7,2,1500,0,0
"el aynaoui y",310,1566.53732176635,274,156,1559.67476501142,125,66,1526.7055222149,16,9,1603.17455024664,117,74,1472.70798026585,16,7,1562.58585259166,149,90,1560.98034765269,223,125,1591.62513993341,51,31
"eleskovic e",311,1467.56771554225,10,2,1458.68621485379,4,0,1500,0,0,1497.58146603404,6,2,1500,0,0,1494.5079061488,6,2,1466.31026534558,10,2,1500,0,0
"elgin m",312,1451.94711928361,11,2,1455.77201400387,7,1,1500,0,0,1500,0,0,1470.62951744034,4,1,1484.37864039069,4,1,1449.53018548798,11,2,1500,0,0
"elias g",313,1532.03924131395,43,16,1481.05607229904,9,2,1474.98083432743,2,0,1558.19854064272,32,14,1500,0,0,1542.87256455872,34,14,1559.17362192171,38,16,1443.99536217487,5,0
"ellwood b",314,1485.07948839757,1,0,1500,0,0,1487.08393385482,1,0,1500,0,0,1500,0,0,1486.20999011832,1,0,1484.87651748224,1,0,1500,0,0
"elseneer g",315,1427.91095509741,38,14,1439.49452388186,10,2,1479.51964041581,20,9,1491.04199892933,5,2,1488.09136455003,3,1,1460.32873792114,28,12,1429.71865842365,28,10,1478.3275273712,10,4
"elsner d",316,1389.65332789139,31,8,1456.10222091402,6,1,1487.5,1,0,1428.99955382703,24,7,1500,0,0,1416.33452647804,25,7,1407.64858138816,25,7,1463.71966273694,6,1
"emmrich m",317,1492.56632185774,1,0,1500,0,0,1490.3471800501,1,0,1500,0,0,1500,0,0,1490.16477861995,1,0,1492.70452559112,1,0,1500,0,0
"enqvist t",318,1508.13813719986,249,137,1542.00946484944,159,91,1508.25928705593,22,11,1482.43072385986,47,23,1513.13948892453,21,12,1473.40047383749,90,46,1514.09891346125,197,108,1529.89786805156,52,29
"eriksson m",319,1454.40094057006,4,0,1485.9199089479,1,0,1500,0,0,1468.02988542794,3,0,1500,0,0,1465.65503347001,3,0,1453.81546266226,4,0,1500,0,0
"erlich j",320,1489.82537169223,9,4,1504.91693347176,6,3,1486.01841882072,3,1,1500,0,0,1500,0,0,1484.58487369086,3,1,1490.55858919112,9,4,1500,0,0
"eschauer w",321,1384.71672672609,52,15,1410.52444421427,12,1,1490.64809982904,3,1,1447.7729270436,36,13,1486.5706852649,1,0,1442.08045778589,40,14,1386.62469161494,42,12,1469.16965841682,10,3
"escobar g",322,1474.54913273303,2,0,1500,0,0,1500,0,0,1475.14915580249,2,0,1500,0,0,1474.11550157769,2,0,1475.20117286612,2,0,1500,0,0
"escobedo e",323,1491.42410880378,6,2,1490.01047731822,3,1,1490.78248228302,3,1,1500,0,0,1500,0,0,1493.97146534378,3,1,1489.29246470168,4,1,1497.38648268609,2,1
"escude n",324,1686.42912453006,185,108,1690.7633174754,104,68,1564.23699954426,28,18,1474.06970939657,28,10,1522.53224576155,25,12,1582.58862065062,81,40,1657.34456675497,148,86,1582.6048353521,37,22
"estrella v",325,1542.94027768932,82,36,1430.08268461475,30,8,1474.23356363306,13,4,1600.38397332837,39,24,1500,0,0,1586.36063655383,52,28,1558.32868247215,67,32,1454.23422886576,15,4
"etlis g",326,1484.78998283221,30,11,1502.53686159712,7,3,1500,0,0,1457.30855904589,23,8,1500,0,0,1461.23455048798,23,8,1472.27011409961,28,10,1504.87793217113,2,1
"eubanks c",327,1480.00717165243,2,0,1478.95592324971,2,0,1500,0,0,1500,0,0,1500,0,0,1500,0,0,1480.36710341335,2,0,1500,0,0
"evans b",328,1456.5128813955,21,6,1413.12509673732,14,2,1512.30167263759,7,4,1500,0,0,1500,0,0,1518.93996679578,7,4,1465.97793517446,17,5,1476.01088349149,4,1
"evans d",329,1598.58070653663,39,17,1557.79256513979,21,10,1483.90777589984,18,7,1500,0,0,1500,0,0,1514.00722761988,18,7,1544.4529016724,26,11,1536.22341246325,13,6
"eysseric j",330,1470.48226459837,3,0,1500,0,0,1500,0,0,1464.38702216024,3,0,1500,0,0,1467.83933451452,3,0,1487.14140959539,1,0,1476.46421762268,2,0
"fabbiano t",331,1467.19940076888,20,5,1500.57090816259,11,4,1500,0,0,1434.29170707163,9,1,1500,0,0,1437.58767174509,9,1,1479.54547595157,17,5,1472.9352158837,3,0
"fahlke a",332,1487.30579267943,1,0,1500,0,0,1500,0,0,1487.06662324804,1,0,1500,0,0,1487.06662324804,1,0,1487.55437296487,1,0,1500,0,0
"falla a",333,1507.13783061762,252,95,1489.80965401171,148,53,1486.25872861107,40,16,1480.31434801402,59,23,1522.77509370657,5,3,1502.06334608009,104,42,1521.69920345042,197,74,1459.48639587363,55,21
"farah r",334,1499.8251026663,9,3,1464.62508382255,3,0,1500,0,0,1528.32084899559,6,3,1500,0,0,1527.74184171854,6,3,1507.51876871702,8,3,1483.75076596085,1,0
"fasching a",335,1487.44725729058,1,0,1500,0,0,1500,0,0,1487.66373726375,1,0,1500,0,0,1487.11401799652,1,0,1488.22132713935,1,0,1500,0,0
"faurel j c",336,1469.77747632807,9,2,1488.21058101022,6,2,1486.46447942316,1,0,1476.58916859085,2,0,1500,0,0,1474.1783804231,3,0,1470.59304481709,5,1,1482.7940577549,4,1
"federer r",337,2102.6969652613,1228,1012,2140.11561898847,742,619,1929.65627856831,165,145,1898.40660317243,262,202,1746.77596423634,59,46,1951.67295705373,486,393,2074.12526335565,846,687,1999.8365836658,382,325
"ferreira w",338,1588.75943959814,211,117,1576.32079576981,134,78,1560.30897321715,29,18,1526.86663439082,37,18,1447.18731682436,11,3,1537.28542925598,77,39,1567.81407598142,158,84,1588.43554178545,53,33
"ferreiro f",339,1489.26733519082,6,2,1500,0,0,1500,0,0,1490.51693141515,6,2,1500,0,0,1489.58234167519,6,2,1497.70599041533,5,2,1490.12183178664,1,0
"ferrer d",340,1795.9222518816,977,653,1800.33748350369,483,313,1637.21529712813,59,39,1864.52623337938,414,292,1490.27670316367,21,9,1797.54344329784,494,340,1767.46359013899,781,512,1830.73001225469,196,141
"ferrero j",341,1480.69133079799,4,1,1487.55983788982,1,0,1500,0,0,1491.35363982719,1,0,1499.87526002089,2,1,1493.45692855144,3,1,1480.96428421837,4,1,1500,0,0
"ferrero j c",342,1673.01590900789,683,440,1625.70843156268,302,174,1621.55896634538,47,30,1691.38433117205,307,221,1527.19652388665,27,15,1685.67911309955,381,266,1665.83649735609,530,337,1636.50876878827,153,103
"fidirko n",343,1487.0021456705,1,0,1485.36005530376,1,0,1500,0,0,1500,0,0,1500,0,0,1500,0,0,1487.44657067015,1,0,1500,0,0
"filippini m",344,1476.81150684089,2,0,1500,0,0,1500,0,0,1477.73206079629,2,0,1500,0,0,1476.82430117533,2,0,1477.64557934487,2,0,1500,0,0
"fischer m",345,1374.88548035267,21,2,1447.35270439008,6,0,1480.37338697425,4,1,1412.92724935092,11,1,1500,0,0,1407.14872852207,15,2,1384.56371997926,17,1,1477.42408319339,4,1
"fish a",346,1491.74135251626,1,0,1492.70276238753,1,0,1500,0,0,1500,0,0,1500,0,0,1500,0,0,1491.82240128979,1,0,1500,0,0
"fish m",347,1739.63501520202,496,289,1705.16278809547,358,214,1685.92567826578,72,46,1531.95032310227,52,23,1483.10967654764,14,6,1681.34052305913,138,75,1719.6100643281,406,237,1689.97822742803,90,52
"fitz s",348,1490.01594495035,1,0,1500,0,0,1488.09047218391,1,0,1500,0,0,1500,0,0,1489.64890103712,1,0,1489.70694571774,1,0,1500,0,0
"flanagan i",349,1524.2291298724,3,2,1500,0,0,1520.87251461716,3,2,1500,0,0,1500,0,0,1522.02962177271,3,2,1521.92641095359,3,2,1500,0,0
"fleischfresser t",350,1485.57146487695,1,0,1500,0,0,1500,0,0,1486.38748850159,1,0,1500,0,0,1485.74049277651,1,0,1486.24162254538,1,0,1500,0,0
"fleishman z",351,1456.47313898999,24,7,1446.00173137648,21,6,1489.60413408257,3,1,1500,0,0,1500,0,0,1490.30823607574,3,1,1456.08571216391,20,6,1476.27143259561,4,1
"fleming c",352,1482.21341549844,2,0,1500,0,0,1477.34786147723,2,0,1500,0,0,1500,0,0,1478.6185695131,2,0,1482.16620478063,2,0,1500,0,0
"flygt k",353,1499.75883182046,4,2,1513.29846883224,3,2,1500,0,0,1488.88822930684,1,0,1500,0,0,1489.17968334171,1,0,1498.63094878918,4,2,1500,0,0
"fnisk",354,1517.02517762631,1,1,1515.21592798052,1,1,1500,0,0,1500,0,0,1500,0,0,1500,0,0,1516.96017703409,1,1,1500,0,0
"fognini f",355,1697.32939924333,454,225,1624.68007396063,171,70,1530.97188415814,27,13,1694.84784833371,255,142,1488.20005683314,1,0,1687.54851330613,283,155,1691.20522136238,387,193,1568.02629688138,67,32
"fogues f",356,1500.30218678601,3,1,1500,0,0,1500,0,0,1495.47870330477,3,1,1500,0,0,1494.4954298355,3,1,1498.0098040123,3,1,1500,0,0
"fornell m",357,1484.66224983638,1,0,1500,0,0,1500,0,0,1484.73049599516,1,0,1500,0,0,1484.3820982429,1,0,1484.79081669004,1,0,1500,0,0
"fraile g",358,1433.24125676078,9,1,1492.57711331361,1,0,1500,0,0,1439.66242247068,8,1,1500,0,0,1435.1299124434,8,1,1433.25029462545,9,1,1500,0,0
"fratangelo b",359,1506.06278967063,17,6,1487.53333507036,14,5,1491.35740009562,1,0,1510.6138115312,2,1,1500,0,0,1507.54540882748,3,1,1515.9011912717,11,5,1472.97563469096,6,1
"freelove o",360,1488.91401316778,1,0,1487.07709401067,1,0,1500,0,0,1500,0,0,1500,0,0,1500,0,0,1488.98226185829,1,0,1500,0,0
"friedl l",361,1484.76357797855,8,3,1472.15133251053,4,1,1500,0,0,1515.32884794384,3,2,1488.5524274831,1,0,1505.88956286822,4,2,1484.98683382859,8,3,1500,0,0
"fritz t",362,1531.23864052429,39,16,1518.87074674905,29,13,1484.06453130146,7,2,1494.5910296357,3,1,1500,0,0,1486.08426920974,10,3,1535.60868843767,35,16,1466.34041190012,4,0
"froberg j",363,1507.24086871113,2,1,1505.5642924567,2,1,1500,0,0,1500,0,0,1500,0,0,1500,0,0,1506.1566429235,2,1,1500,0,0
"fromberg r",364,1413.80286064012,49,19,1487.81720629224,26,12,1499.95374611327,4,2,1412.98159827556,19,5,1500,0,0,1412.35231370585,23,7,1430.7505191723,39,15,1472.23523307682,10,4
"fruttero j p",365,1488.1603277259,1,0,1487.32844616105,1,0,1500,0,0,1500,0,0,1500,0,0,1500,0,0,1488.11400112758,1,0,1500,0,0
"fucsovics m",366,1475.86680385324,8,2,1495.26198997129,3,1,1487.0262101217,1,0,1484.76743923924,4,1,1500,0,0,1474.95236433619,5,1,1478.77283164234,7,2,1492.5258228603,1,0
"fukarek o",367,1397.95121975453,14,2,1418.2674794086,9,1,1488.19191033066,3,1,1476.19943129508,2,0,1500,0,0,1465.01144570582,5,1,1415.69217463798,12,2,1474.93904760831,2,0
"furlan r",368,1458.14657618975,18,6,1479.17372341459,11,4,1500,0,0,1470.45217596885,7,2,1500,0,0,1471.16053424649,7,2,1450.0468346785,16,5,1501.58984412111,2,1
"fyrstenberg m",369,1473.55968562203,3,0,1500,0,0,1500,0,0,1472.68018254618,3,0,1500,0,0,1472.14791667357,3,0,1473.56243837577,3,0,1500,0,0
"gabashvili t",370,1522.59776409354,300,109,1486.49729443221,155,55,1428.93626972548,22,6,1527.20017081851,103,41,1464.89123459825,20,7,1508.06560263942,145,54,1496.1352879919,251,91,1493.77588021034,49,18
"gaio f",371,1482.86606609182,2,0,1487.60225090533,1,0,1500,0,0,1492.17238403949,1,0,1500,0,0,1492.58395232157,1,0,1481.41653003837,2,0,1500,0,0
"galan d e",372,1504.37278849747,2,1,1500,0,0,1500,0,0,1500.99008667724,2,1,1500,0,0,1503.94689290849,2,1,1504.32123361096,2,1,1500,0,0
"galdon p",373,1496.23631612093,1,0,1500,0,0,1500,0,0,1496.57963044906,1,0,1500,0,0,1496.37201269841,1,0,1495.31343236752,1,0,1500,0,0
"galimberti g",374,1413.08062688335,21,5,1453.52976268974,6,1,1500,0,0,1469.00469076805,12,4,1461.50733076843,3,0,1437.22977227217,15,4,1418.08153985438,15,3,1475.79545831643,6,2
"gallardo m",375,1466.49210779694,4,0,1500,0,0,1500,0,0,1469.96013193846,4,0,1500,0,0,1467.23592854661,4,0,1467.57074499144,4,0,1500,0,0
"galovic v",376,1491.21941471848,1,0,1500,0,0,1500,0,0,1491.35147943506,1,0,1500,0,0,1491.42460334157,1,0,1491.64267611393,1,0,1500,0,0
"galvani s",377,1433.71653493889,51,16,1445.93484035498,16,4,1486.31108392027,7,3,1434.36553462592,26,8,1501.31770438642,2,1,1452.24497997718,35,12,1436.71047352137,37,12,1449.1999324909,14,4
"gambill j m",378,1476.64893244689,275,141,1488.92252294706,201,112,1515.68023145602,33,18,1386.25777728332,30,7,1463.32198520294,11,4,1408.75088527257,74,29,1479.04595892038,233,122,1484.98318060027,42,19
"gamonal h",379,1470.05802196063,7,2,1485.27375945655,1,0,1500,0,0,1483.05820537066,6,2,1500,0,0,1480.31320955434,6,2,1482.30674136435,6,2,1486.54131284969,1,0
"gao x",380,1487.51381830949,1,0,1489.14321245439,1,0,1500,0,0,1500,0,0,1500,0,0,1500,0,0,1488.52906267696,1,0,1500,0,0
"garcia a",381,1380.68453831274,34,9,1434.21240452242,11,2,1479.31127852558,2,0,1447.86093086423,21,7,1500,0,0,1423.13130467272,23,7,1386.42605406788,33,9,1486.66770150597,1,0
"garcia lopez g",382,1542.79290593971,575,270,1501.92920843626,273,120,1474.28160950065,54,26,1655.35649774115,240,122,1466.34391289277,8,2,1610.09530148844,302,150,1538.85338966651,487,231,1522.93995518813,88,39
"garcia m",383,1477.75071737273,2,0,1500,0,0,1489.05126175977,1,0,1487.5,1,0,1500,0,0,1477.01045153717,2,0,1478.4388284006,2,0,1500,0,0
"garcia sintes j",384,1488.4945378498,1,0,1500,0,0,1500,0,0,1489.83677377415,1,0,1500,0,0,1489.22671784611,1,0,1488.49849145167,1,0,1500,0,0
"gard c",385,1489.56575177209,1,0,1500,0,0,1500,0,0,1487.60910635834,1,0,1500,0,0,1488.92597873264,1,0,1489.72930152658,1,0,1500,0,0
"garin c",386,1477.20696948764,5,1,1500,0,0,1500,0,0,1473.77875932349,5,1,1500,0,0,1474.32781114503,5,1,1473.80686861272,5,1,1500,0,0
"garza d",387,1462.05901627033,4,0,1493.24900054755,1,0,1500,0,0,1465.85548889621,3,0,1500,0,0,1466.05373500351,3,0,1460.18196449869,4,0,1500,0,0
"gasquet r",388,1822.84030878902,696,444,1771.64396131036,414,259,1685.03609759934,80,55,1810.43065277323,184,118,1578.2263791357,18,12,1818.70199077232,282,185,1782.80691049636,552,348,1807.48907669493,144,96
"gaudenzi a",389,1436.70397683878,107,39,1379.36423324644,37,9,1475.44842793373,2,0,1496.27958106704,60,28,1461.21193116267,8,2,1476.56960282698,70,30,1442.30251173926,91,34,1447.27038925555,16,5
"gaudi i",390,1489.16971005653,1,0,1500,0,0,1487.5,1,0,1500,0,0,1500,0,0,1487.90038275359,1,0,1500,0,0,1489.21036834272,1,0
"gaudio g",391,1500.08466250973,417,244,1520.19304174186,115,50,1471.33896068705,7,2,1539.43430458774,275,184,1469.16449387707,20,8,1517.53530527192,302,194,1505.09221441146,347,207,1575.32922039207,70,37
"gensse a",392,1492.28393188579,4,1,1494.52308186622,1,0,1500,0,0,1495.55422088232,3,1,1500,0,0,1495.04127478384,3,1,1500.14666922308,2,1,1483.69404779913,2,0
"gerasimov e",393,1487.22245958394,1,0,1487.02430632159,1,0,1500,0,0,1500,0,0,1500,0,0,1500,0,0,1486.61922045611,1,0,1500,0,0
"ghedin r",394,1471.15998940526,3,0,1487.90713030778,1,0,1477.50536381148,2,0,1500,0,0,1500,0,0,1478.76125042378,2,0,1479.59732433019,2,0,1490.12608150461,1,0
"ghem a",395,1476.46188423434,7,2,1500,0,0,1500,0,0,1479.28789351675,7,2,1500,0,0,1475.9192695155,7,2,1477.0966827936,7,2,1500,0,0
"giannessi a",396,1483.48023637085,11,4,1508.30351483119,2,1,1500,0,0,1476.21349207332,9,3,1500,0,0,1472.88653495083,9,3,1475.24888041163,9,3,1509.27610916786,2,1
"gicquel m",397,1479.05006839492,205,92,1533.67905652782,99,43,1466.45107542406,26,11,1487.92025785244,59,26,1520.57030349729,21,12,1441.07933103171,106,49,1516.49398243657,166,77,1466.83951182133,39,15
"gigounon g",398,1497.00507207884,1,0,1500,0,0,1500,0,0,1495.62478993684,1,0,1500,0,0,1495.46578547574,1,0,1500,0,0,1494.72636344905,1,0
"gil f",399,1555.53339687456,115,49,1521.97753596251,40,16,1443.45668325102,8,1,1545.78331133458,67,32,1500,0,0,1518.94468238826,75,33,1549.66774047657,98,46,1435.10917012475,17,3
"gimelstob j",400,1435.77874159275,152,56,1423.70533185068,97,34,1512.67361343167,40,20,1423.13887493274,13,2,1479.25145953909,2,0,1457.30763216335,55,22,1429.86875732346,121,45,1448.24883322343,31,11
"gimeno d",401,1491.982077955,1,0,1500,0,0,1500,0,0,1490.67345506875,1,0,1500,0,0,1491.2639321917,1,0,1491.37781042231,1,0,1500,0,0
"gimeno traver d",402,1521.80048198929,261,95,1382.62831630217,67,17,1376.51879765446,19,2,1553.26749501133,175,76,1500,0,0,1526.23954379203,194,78,1531.06478123452,225,87,1382.21266487016,36,8
"ginepri r",403,1542.10945585047,378,184,1504.01644329318,266,136,1479.79671221862,50,24,1514.08722129006,42,15,1492.31792437267,20,9,1542.38021548996,112,48,1535.04829880209,311,153,1512.65860974341,67,31
"giner j",404,1491.47929497434,5,2,1500,0,0,1500,0,0,1495.53141732475,5,2,1500,0,0,1492.63230405354,5,2,1491.51362330228,5,2,1500,0,0
"giraldo s",405,1539.48152658044,307,135,1494.64430997459,138,53,1476.35361310745,28,12,1556.74213781169,140,70,1490.46247809127,1,0,1539.21793361596,169,82,1553.23811153226,265,123,1417.79948584479,42,12
"giron m",406,1481.71906679459,2,0,1483.16122571599,2,0,1500,0,0,1500,0,0,1500,0,0,1500,0,0,1485.04276711794,1,0,1492.32233382077,1,0
"giustino l",407,1482.17902021025,2,0,1500,0,0,1500,0,0,1481.1658605171,2,0,1500,0,0,1483.57311784541,2,0,1480.95211070827,2,0,1500,0,0
"godwin n",408,1430.91247759758,28,10,1400.84671122656,13,2,1506.16266110388,15,8,1500,0,0,1500,0,0,1518.7520843814,15,8,1431.69580972138,23,8,1494.29540760306,5,2
"goellner m k",409,1452.9286660909,25,9,1504.36026899753,6,3,1475,2,0,1454.46191250537,17,6,1500,0,0,1439.31383596759,19,6,1457.08722693655,24,9,1486.90252653804,1,0
"goffin d",410,1833.66227808585,224,125,1770.30061782631,143,81,1572.87669919397,27,14,1695.98453368512,54,30,1500,0,0,1730.40576221571,81,44,1806.52046149024,181,100,1634.2000826666,43,25
"gojowczyk p",411,1534.27772524119,26,10,1538.24802293455,18,8,1496.92212560304,4,2,1457.04613272357,4,0,1500,0,0,1465.68542955501,8,2,1541.87168040738,18,8,1468.19671978696,8,2
"golding o",412,1465.48210831139,3,0,1500,0,0,1462.64792343157,3,0,1500,0,0,1500,0,0,1462.7906263977,3,0,1475.75869063191,2,0,1489.68131839005,1,0
"goldstein p",413,1516.84990614709,165,72,1526.94411605627,117,51,1493.49598340162,17,8,1484.17236550022,26,11,1490.47582907082,5,2,1477.00363645741,48,21,1532.76827077036,143,65,1444.92534149539,22,7
"golmard j",414,1528.93079300016,142,76,1568.36497579495,86,50,1454.42540194182,12,4,1520.39445933249,38,20,1477.49820322675,6,2,1462.780115845,56,26,1556.72117855373,120,67,1474.93151122818,22,9
"golovanov d",415,1459.75182426247,5,0,1491.50247319112,1,0,1485.4129468086,1,0,1500,0,0,1467.16697332023,3,0,1461.83740244836,4,0,1471.40763410008,4,0,1485.64176589579,1,0
"golubev a",416,1468.36414992053,158,51,1447.89998129004,91,28,1421.4464770039,11,1,1483.3948635164,49,17,1544.77637809978,7,5,1477.90203145757,67,23,1471.03883950704,134,47,1423.73578660607,24,4
"gombos n",417,1476.9201311011,4,0,1478.64190160705,3,0,1500,0,0,1489.21903659543,1,0,1500,0,0,1488.68937119504,1,0,1474.85969188826,4,0,1500,0,0
"gomez a",418,1504.84458691074,2,1,1500,0,0,1500,0,0,1497.95986996791,2,1,1500,0,0,1502.31489392146,2,1,1504.05680412876,2,1,1500,0,0
"gomez e",419,1502.52953950472,3,1,1489.52742451723,1,0,1500,0,0,1504.38214321681,2,1,1500,0,0,1504.83707537091,2,1,1500.61888666263,3,1,1500,0,0
"gomez herrera c",420,1489.36140764235,1,0,1500,0,0,1500,0,0,1489.48355366305,1,0,1500,0,0,1489.21116983108,1,0,1489.31020450679,1,0,1500,0,0
"gomez l",421,1483.37185853679,2,0,1476.94839961857,2,0,1500,0,0,1500,0,0,1500,0,0,1500,0,0,1483.21882576803,2,0,1500,0,0
"gong m x",422,1477.39900046859,4,0,1474.35826761587,4,0,1500,0,0,1500,0,0,1500,0,0,1500,0,0,1474.28858940578,4,0,1500,0,0
"gonzalez a",423,1422.31277685419,46,12,1466.39283648322,21,6,1474.82770356918,2,0,1422.68751488303,23,6,1500,0,0,1413.85339924986,25,6,1409.197342946,37,9,1483.42433367925,9,3
"gonzalez f",424,1679.82198167712,515,325,1672.81910894219,246,146,1600.16212606586,35,22,1752.60488504279,207,141,1552.66434012896,27,16,1730.6469880725,269,179,1681.33500182793,396,250,1698.91615444993,119,75
"gonzalez m",425,1418.00920499417,84,27,1427.71015269414,16,3,1460.28375028266,4,0,1447.16597795059,64,24,1500,0,0,1431.47460420389,68,24,1436.13158869116,65,22,1441.67485684994,19,5
"gonzalez p",426,1486.5699717041,1,0,1500,0,0,1500,0,0,1487.05047029068,1,0,1500,0,0,1487.05047029068,1,0,1486.58603521976,1,0,1500,0,0
"gonzalez s",427,1454.23846248463,9,1,1485.67140368285,1,0,1486.16566737048,1,0,1476.44935078759,7,1,1500,0,0,1462.1088405592,8,1,1461.59956274254,8,1,1487.37165354125,1,0
"goodall j",428,1421.53637421128,12,1,1489.23838964187,1,0,1418.55387050128,11,1,1500,0,0,1500,0,0,1418.38229040131,11,1,1470.61816032105,6,1,1431.00785616045,6,0
"gooding j",429,1493.22722445366,1,0,1492.06816915026,1,0,1500,0,0,1500,0,0,1500,0,0,1500,0,0,1492.58246693133,1,0,1500,0,0
"goransson t",430,1472.96432073197,2,0,1500,0,0,1500,0,0,1472.83520522604,2,0,1500,0,0,1472.43936711363,2,0,1473.34442712705,2,0,1500,0,0
"granollers m",431,1636.43793321574,397,185,1585.72262561867,171,77,1479.82861541123,27,10,1572.36916727735,196,97,1492.20789692189,3,1,1581.12846477199,226,108,1577.83265940325,325,150,1608.99945117688,72,35
"granollers pujol g",432,1458.11209648396,4,0,1500,0,0,1500,0,0,1460.51539775101,4,0,1500,0,0,1460.06474842253,4,0,1458.04870960926,4,0,1500,0,0
"gregorc l",433,1534.20619084857,13,6,1526.58062376361,12,6,1488.77179881644,1,0,1500,0,0,1500,0,0,1496.20550269756,1,0,1535.83141788968,12,6,1494.25183895886,1,0
"gremelmayr d",434,1458.33484637806,87,31,1440.92482910398,45,15,1439.99116256133,10,2,1523.34844926708,28,13,1476.7613825845,4,1,1455.8800441729,42,16,1479.08890765193,74,28,1443.87790616078,13,3
"greul s",435,1528.22629765537,115,43,1473.69755220033,52,19,1474.00578842952,9,3,1494.36249618533,52,20,1498.56315127591,2,1,1513.22610858648,63,24,1544.83217164753,101,41,1427.91530179234,14,2
"grigelis l",436,1490.07623738848,1,0,1487.69003755132,1,0,1500,0,0,1500,0,0,1500,0,0,1500,0,0,1488.78226263333,1,0,1500,0,0
"grosjean s",437,1513.46784641696,455,269,1497.75059611786,258,147,1607.41357553737,62,42,1594.27040852178,99,59,1558.37727210838,36,21,1590.83399936984,197,122,1510.11348773816,347,197,1624.28688818497,108,72
"gross o",438,1448.8107240732,12,3,1487.92866525186,1,0,1487.41403230829,1,0,1464.41146216809,10,3,1500,0,0,1453.24509778882,11,3,1448.06757026908,12,3,1500,0,0
"groth s",439,1524.02270712915,88,34,1450.1934110962,56,19,1532.04227525734,23,12,1499.52646474833,9,3,1500,0,0,1553.1451822765,32,15,1489.52174686185,70,27,1521.27391767845,18,7
"gruber k",440,1491.84323563745,1,0,1491.52594653629,1,0,1500,0,0,1500,0,0,1500,0,0,1500,0,0,1491.59335940705,1,0,1500,0,0
"guardiola t",441,1452.85474395021,9,2,1503.74992284716,4,2,1500,0,0,1453.56483246912,4,0,1487.5,1,0,1441.11132777599,5,0,1463.2933121392,7,2,1478.3988148222,2,0
"guccione a",442,1493.39397192829,3,1,1500,0,0,1495.58485036742,2,1,1486.87957690039,1,0,1500,0,0,1492.41304824576,3,1,1486.60973685861,1,0,1505.26494161022,2,1
"guccione c",443,1494.58845992621,89,34,1529.59440655153,64,27,1437.078297812,16,5,1458.26889987937,8,2,1492.79087021489,1,0,1411.71272908518,25,7,1509.33837835757,72,30,1416.37294135666,17,4
"guez d",444,1419.98190098456,18,2,1429.19421654242,14,2,1500,0,0,1474.0914361509,3,0,1485.21424215486,1,0,1468.10423633135,4,0,1433.31509851491,14,2,1464.08432365948,4,0
"gulbis e",445,1577.12647641217,395,197,1553.83714352462,235,120,1469.66917743526,29,10,1634.1159764023,118,60,1517.48216515029,13,7,1605.23324464676,160,77,1548.91162474984,328,166,1545.68570319335,67,31
"gumy h",446,1437.4412309496,31,11,1469.36019695372,9,3,1487.96400122406,1,0,1456.00417938915,21,8,1500,0,0,1446.47367645723,22,8,1440.25551523176,25,9,1479.16558822975,6,2
"gustafsson m",447,1556.08193176772,68,36,1497.31927474973,18,8,1505.66774714701,12,6,1554.71066322527,31,18,1511.45775487763,7,4,1556.68981139569,50,28,1571.0440391655,59,33,1470.50527530781,9,3
"gutierrez ferrol s",448,1499.29780111069,4,2,1500,0,0,1500,0,0,1502.91412947392,4,2,1500,0,0,1502.01393482932,4,2,1499.81521252888,4,2,1500,0,0
"guzman j",449,1488.15073774422,1,0,1500,0,0,1487.24829816653,1,0,1500,0,0,1500,0,0,1488.05909069974,1,0,1500,0,0,1488.80925558678,1,0
"guzman j p",450,1434.44221737788,21,6,1485.73367003116,3,1,1486.71667462987,1,0,1451.05205173426,17,5,1500,0,0,1441.54725744148,18,5,1455.78732158616,18,6,1464.84383273181,3,0
"haas p",451,1494.87633358969,1,0,1500,0,0,1500,0,0,1493.88830827479,1,0,1500,0,0,1492.88298162225,1,0,1494.56013103379,1,0,1500,0,0
"haas t",452,1669.7758677183,661,423,1666.82845880901,417,271,1661.32899557905,66,43,1700.92618127918,148,91,1574.24365144103,30,18,1715.93603808691,244,152,1684.98212250655,524,334,1663.66563057862,137,89
"haase r",453,1587.21664877129,315,140,1498.16711273067,153,59,1502.47635181657,34,13,1569.79585825807,125,66,1514.43210168439,3,2,1591.86590454633,162,81,1592.19490546335,269,125,1468.43854765876,46,15
"hadad a",454,1500.91291458754,6,3,1503.87924203177,4,2,1500,0,0,1501.12298920912,2,1,1500,0,0,1500.18961984978,2,1,1500.21618077173,4,2,1499.28398244317,2,1
"hadad m",455,1498.20845600365,4,2,1500,0,0,1500,0,0,1499.34518111631,4,2,1500,0,0,1498.16197642203,4,2,1499.47760586005,4,2,1500,0,0
"haehnel j",456,1444.26125990853,26,8,1522.32000380994,10,6,1466.40950978924,3,0,1435.59800573111,10,1,1491.55873432424,3,1,1409.88542841068,16,2,1468.54869266316,20,7,1459.49815943555,6,1
"haider maurer a",457,1545.88652973839,101,39,1487.54391199833,36,12,1447.05995580423,13,4,1529.17977034385,52,23,1500,0,0,1506.75096262484,65,27,1532.22654524687,79,32,1466.13645716436,22,7
"hajek j",458,1431.45318092964,98,27,1348.34840148886,45,8,1464.4159008255,4,0,1505.42123532252,48,19,1488.57916233843,1,0,1498.28006208883,53,19,1435.18894317693,78,22,1442.68788049321,20,5
"hajji a",459,1467.86563820419,3,0,1466.16073825668,3,0,1500,0,0,1500,0,0,1500,0,0,1500,0,0,1467.66025860046,3,0,1500,0,0
"halys q",460,1491.99445041225,11,3,1494.38205911905,6,2,1500,0,0,1487.58751918197,5,1,1500,0,0,1487.12082064727,5,1,1466.78229542842,6,1,1508.98613971838,5,2
"hamou m",461,1480.99593042302,2,0,1500,0,0,1500,0,0,1475.40530470157,2,0,1500,0,0,1477.52023899704,2,0,1487.44738756146,1,0,1492.01648245803,1,0
"hanescu v",462,1565.92913146233,412,186,1462.63964145809,139,47,1463.19147999208,32,13,1618.67428317636,227,121,1467.33142555186,14,5,1591.07030844672,273,139,1562.25153316606,342,155,1501.30482597804,70,31
"hank t",463,1472.71199289656,3,0,1471.80306188616,3,0,1500,0,0,1500,0,0,1500,0,0,1500,0,0,1471.43604981718,3,0,1500,0,0
"hanley p",464,1487.73089607115,1,0,1485.81727880318,1,0,1500,0,0,1500,0,0,1500,0,0,1500,0,0,1488.05269797444,1,0,1500,0,0
"hantschk m",465,1409.83904707436,60,24,1432.61123915467,26,9,1475.03176437078,4,1,1475.3784244352,30,14,1500,0,0,1462.62484440498,34,15,1424.05415279805,55,23,1466.09240323868,5,1
"harboe p",466,1489.44576723673,1,0,1500,0,0,1500,0,0,1489.88289819676,1,0,1500,0,0,1489.93071966724,1,0,1489.25986167728,1,0,1500,0,0
"harper griffith l",467,1478.3453841067,2,0,1488.00431612765,1,0,1500,0,0,1487.5,1,0,1500,0,0,1487.5,1,0,1487.02758889245,1,0,1487.44071402391,1,0
"harrison c",468,1500.38614151435,3,1,1497.18933897626,3,1,1500,0,0,1500,0,0,1500,0,0,1500,0,0,1509.29506957281,2,1,1488.34014790485,1,0
"harrison r",469,1618.59506496815,174,72,1608.54497717904,131,56,1467.20942901503,27,11,1455.81717880667,16,5,1500,0,0,1459.59208585101,43,16,1592.33176719711,146,64,1473.87087902767,28,8
"harsanyi p",470,1475.41128996281,2,0,1473.58826250322,2,0,1500,0,0,1500,0,0,1500,0,0,1500,0,0,1475.00962184627,2,0,1500,0,0
"hartfield d",471,1486.45692923041,45,17,1464.70452028454,7,1,1473.1067149695,2,0,1510.59812984541,32,14,1502.39526261581,4,2,1501.46303614526,38,16,1493.98747854592,39,16,1475.52326209878,6,1
"healey n",472,1478.80454957058,18,6,1470.15438293832,15,5,1499.78292778308,2,1,1492.25362969688,1,0,1500,0,0,1493.93328361644,3,1,1457.80743510888,12,3,1504.15257304039,6,3
"hellstrom m",473,1487.67178071386,1,0,1500,0,0,1500,0,0,1486.39332541442,1,0,1500,0,0,1485.92075844251,1,0,1487.34650468495,1,0,1500,0,0
"hemery c",474,1498.24042995953,3,1,1500,0,0,1500,0,0,1499.76403367678,3,1,1500,0,0,1498.26543048257,3,1,1497.47073043339,3,1,1500,0,0
"hemmes f",475,1486.76623194094,4,1,1504.56815724513,2,1,1489.99694922962,1,0,1487.06032439041,1,0,1500,0,0,1478.79394346798,2,0,1484.47009845879,4,1,1500,0,0
"henman t",476,1612.19940991244,423,277,1632.43531941089,249,164,1647.73071301055,60,42,1596.25108841939,77,45,1611.82188327646,37,26,1625.17701191489,174,113,1614.60965649096,326,210,1624.96325658146,97,67
"henry r",477,1484.23751189223,1,0,1485.337222933,1,0,1500,0,0,1500,0,0,1500,0,0,1500,0,0,1500,0,0,1486.88911541988,1,0
"herbert p h",478,1561.63525860062,51,20,1521.55913179013,37,15,1515.43658651744,9,4,1485.87125144722,5,1,1500,0,0,1518.53668609568,14,5,1538.17692863539,38,15,1490.69434177956,13,5
"herm zahlava j",479,1473.06144293357,2,0,1500,0,0,1500,0,0,1473.63697505522,2,0,1500,0,0,1473.44448999822,2,0,1473.66183197938,2,0,1500,0,0
"hernandez a",480,1456.34413083231,6,1,1500,0,0,1500,0,0,1462.06381787956,6,1,1500,0,0,1458.54310016015,6,1,1458.34790528765,6,1,1500,0,0
"hernandez o",481,1424.52019489643,190,65,1341.4185010813,34,4,1419.72503554914,10,1,1496.99766356735,143,59,1487.13967024683,3,1,1472.54073196623,156,61,1458.4011845263,160,59,1367.89712856462,30,6
"hernych j",482,1588.38289762142,193,80,1509.34710713166,98,41,1527.03004212057,40,19,1456.76619947974,40,13,1504.80612725754,15,7,1544.61257788117,95,39,1569.88281093845,163,70,1471.12594423643,30,10
"heuberger i",483,1421.45287253453,79,25,1425.40817279393,47,16,1465.21278679611,8,2,1426.62393687685,12,2,1480.44894370798,12,5,1423.77431879196,32,9,1418.825008832,66,22,1446.67887933892,13,3
"hewitt l",484,1600.03569170525,722,511,1617.91120627158,458,321,1689.01827675618,133,103,1610.15368299378,118,78,1569.78505299699,13,9,1638.90615695198,264,190,1622.30105898562,516,367,1637.99887423076,206,144
"hill m",485,1487.94433938657,3,1,1500.06196425891,2,1,1487.94952970932,1,0,1500,0,0,1500,0,0,1487.93337675196,1,0,1487.89934909509,1,0,1500,2,1
"hilton m",486,1478.76122813655,5,1,1500,0,0,1465.08228024381,5,1,1500,0,0,1500,0,0,1473.11309149,5,1,1489.96785735192,1,0,1484.85646016249,4,1
"hipfl m",487,1428.31491318567,90,36,1434.8557998572,17,4,1454.04130839282,6,1,1466.69035196533,67,31,1500,0,0,1438.14465025839,73,32,1446.85384637253,78,34,1420.60024767707,12,2
"hippensteel k",488,1484.20152797275,4,1,1475.76271007315,4,1,1500,0,0,1500,0,0,1500,0,0,1500,0,0,1490.97199268672,3,1,1486.36877043224,1,0
"hirigoyen i",489,1480.14043088604,4,1,1488.65424741998,1,0,1500,0,0,1485.63676786699,3,1,1500,0,0,1485.54328324758,3,1,1478.01618420087,4,1,1500,0,0
"hocevar r",490,1449.13015349483,5,0,1494.09399579461,1,0,1500,0,0,1456.77585753866,4,0,1500,0,0,1454.55762699108,4,0,1453.56924931145,4,0,1495.94599313676,1,0
"hood m",491,1487.31042255386,5,2,1500,0,0,1500,0,0,1488.82661910907,5,2,1500,0,0,1487.18245743449,5,2,1487.56996255325,5,2,1500,0,0
"hormazabal g",492,1463.47703129326,3,0,1500,0,0,1500,0,0,1467.23034895001,3,0,1500,0,0,1466.31218041327,3,0,1464.90312700683,3,0,1500,0,0
"horna l",493,1508.92340508085,249,113,1454.95531292682,81,32,1432.7834489306,6,0,1572.64023780452,159,81,1463.34826493742,3,0,1541.02464625213,168,81,1543.40970285472,215,104,1388.21426108983,34,9
"hossam k",494,1497.30564933571,1,0,1497.04904969203,1,0,1500,0,0,1500,0,0,1500,0,0,1500,0,0,1496.56980024984,1,0,1500,0,0
"hrbaty d",495,1497.63291690507,453,234,1521.18429212521,263,143,1443.35814537367,20,6,1497.9216012132,124,60,1545.48415618742,46,25,1489.18369179668,190,91,1519.37516354084,372,191,1515.09891089403,81,43
"huet s",496,1395.61646482827,27,6,1428.77781289774,9,1,1490.93661414021,5,2,1460.75481283887,10,3,1463.83133671542,3,0,1437.34864700865,18,5,1397.20929905199,20,4,1469.67951208301,7,2
"hui j",497,1494.9255833273,1,0,1494.58348798335,1,0,1500,0,0,1500,0,0,1500,0,0,1500,0,0,1493.25634043111,1,0,1500,0,0
"humphries s",498,1457.55377365069,4,0,1466.78068029028,3,0,1500,0,0,1488.88517875201,1,0,1500,0,0,1488.88517875201,1,0,1456.07062128465,4,0,1500,0,0
"huta galung j",499,1405.42238744534,30,5,1414.79797099581,17,2,1468.68131199722,8,2,1472.44470274831,5,1,1500,0,0,1458.41719279227,13,3,1429.14259430122,25,5,1440.8533533896,5,0
"hutchins r",500,1487.92447600427,1,0,1487.14733571845,1,0,1500,0,0,1500,0,0,1500,0,0,1500,0,0,1488.51011668184,1,0,1500,0,0
"ianni s",501,1505.30471481406,2,1,1500,0,0,1500,0,0,1502.69961804671,2,1,1500,0,0,1504.29165859612,2,1,1502.36268768577,2,1,1500,0,0
"idmbarek y",502,1480.66916116394,2,0,1500,0,0,1500,0,0,1478.30044660377,2,0,1500,0,0,1479.64959182886,2,0,1479.47582905335,2,0,1500,0,0
"ignatik u",503,1490.31084557458,1,0,1489.78580734217,1,0,1500,0,0,1500,0,0,1500,0,0,1500,0,0,1489.53549417191,1,0,1500,0,0
"ilhan m",504,1438.52485804174,70,19,1428.43548191818,41,11,1475.8162334421,9,3,1442.76344957027,20,5,1500,0,0,1444.38421757962,29,8,1406.96794180893,51,12,1492.05342341449,19,7
"ilie a",505,1392.71076553884,104,41,1400.4532857974,56,18,1435.56371074905,6,0,1513.1026073063,39,22,1487.05047029068,3,1,1458.01241004965,48,23,1413.97474478656,86,34,1460.79141702548,18,7
"ilkel c",506,1465.02496570973,4,0,1477.13436046153,2,0,1500,0,0,1481.93539961284,2,0,1500,0,0,1481.23980072485,2,0,1462.60450648344,4,0,1500,0,0
"im k t",507,1486.75802874768,1,0,1487.02428026995,1,0,1500,0,0,1500,0,0,1500,0,0,1500,0,0,1486.68220259045,1,0,1500,0,0
"inglot d",508,1484.90366295473,2,0,1477.49782179152,2,0,1500,0,0,1500,0,0,1500,0,0,1500,0,0,1485.17529012737,2,0,1500,0,0
"ionita v",509,1467.58914429782,3,0,1500,0,0,1500,0,0,1466.15881193261,3,0,1500,0,0,1464.97333505131,3,0,1464.29754272984,3,0,1500,0,0
"ishii y",510,1451.67875726295,4,0,1450.1681471853,4,0,1500,0,0,1500,0,0,1500,0,0,1500,0,0,1450.92093593032,4,0,1500,0,0
"isner j",511,1823.75398462183,490,306,1814.75493315092,355,230,1618.97863341075,46,28,1637.78797116428,89,48,1500,0,0,1665.1529204099,135,76,1798.36172428422,401,251,1705.91349457256,89,55
"istomin d",512,1557.13516241263,357,162,1509.52478154045,218,98,1586.89248848331,56,32,1522.72660202811,80,31,1487.18322526489,3,1,1592.26476314904,139,64,1527.4613194087,294,132,1562.58129838164,63,30
"ito t",513,1519.15208148274,76,27,1463.78584630499,49,16,1497.19320835475,18,8,1481.84818606043,9,3,1500,0,0,1498.88747125426,27,11,1519.59166725464,62,24,1434.63672744598,14,3
"ito y",514,1487.28016443549,1,0,1487.37634222817,1,0,1500,0,0,1500,0,0,1500,0,0,1500,0,0,1487.57636479246,1,0,1500,0,0
"ittogi t",515,1488.06664971285,1,0,1487.81782492635,1,0,1500,0,0,1500,0,0,1500,0,0,1500,0,0,1488.02450848548,1,0,1500,0,0
"ivanisevic g",516,1487.85299304957,108,46,1488.16910972989,72,32,1571.82888965054,19,12,1398.60781527694,10,0,1465.68647178851,7,2,1486.04765484178,36,14,1420.78365840399,88,33,1581.52811739745,20,13
"ivanov smolensky k",517,1472.35148865052,2,0,1487.74432044863,1,0,1487.09484338784,1,0,1500,0,0,1500,0,0,1486.76124973996,1,0,1473.68605427739,2,0,1500,0,0
"ivashka i",518,1494.26305054685,1,0,1490.18016373245,1,0,1500,0,0,1500,0,0,1500,0,0,1500,0,0,1500,0,0,1487.01039441558,1,0
"iwabuchi s",519,1435.24024624934,13,3,1434.60784755383,13,3,1500,0,0,1500,0,0,1500,0,0,1500,0,0,1433.49469949985,13,3,1500,0,0
"iwami t",520,1469.7543885752,4,1,1470.32554622717,4,1,1500,0,0,1500,0,0,1500,0,0,1500,0,0,1470.01961716036,4,1,1500,0,0
"janowicz j",521,1623.28835119264,152,74,1613.62404001521,96,49,1558.04482636026,20,12,1506.85613912466,36,13,1500,0,0,1561.39075530604,56,25,1627.47422823712,115,53,1581.16242117595,37,21
"jarry n",522,1479.58440352916,5,1,1477.08106576553,2,0,1500,0,0,1498.7965965446,3,1,1500,0,0,1498.21445922381,3,1,1477.65273344527,5,1,1500,0,0
"jasika o",523,1498.1883095659,3,1,1495.83651750399,3,1,1500,0,0,1500,0,0,1500,0,0,1500,0,0,1484.94159898613,1,0,1508.30602608273,2,1
"jaziri m",524,1577.95550792994,105,41,1530.39537287772,69,27,1461.80393535059,18,6,1515.03047705822,18,8,1500,0,0,1498.07379633066,36,14,1579.46222737259,86,35,1457.11026189232,19,6
"jeanpierre j",525,1523.04655565513,5,3,1506.07091921604,2,1,1500,0,0,1509.82428212683,3,2,1500,0,0,1510.58402528279,3,2,1504.96072620064,2,1,1508.16292134057,3,2
"jelenic p",526,1499.80325159147,2,1,1499.14708037148,2,1,1500,0,0,1500,0,0,1500,0,0,1500,0,0,1499.57797787821,2,1,1500,0,0
"jenkins s",527,1451.78641885864,20,5,1444.23470007184,13,2,1500.51858243787,2,1,1488.11571086904,5,2,1500,0,0,1486.72208079084,7,3,1468.5015707082,13,4,1466.22047225792,7,1
"jensen l",528,1487.193203992,1,0,1487.193203992,1,0,1500,0,0,1500,0,0,1500,0,0,1500,0,0,1487.54666650777,1,0,1500,0,0
"jeong s y",529,1492.77294719351,1,0,1492.68153446319,1,0,1500,0,0,1500,0,0,1500,0,0,1500,0,0,1491.1987336665,1,0,1500,0,0
"jiang s",530,1486.78737128407,1,0,1489.02949817689,1,0,1500,0,0,1500,0,0,1500,0,0,1500,0,0,1487.44893267403,1,0,1500,0,0
"johansson j",531,1672.41877495037,119,67,1683.15948761089,88,55,1517.72107305863,12,6,1418.31050141927,13,2,1524.86549831542,6,4,1475.93069669621,31,12,1651.27196801846,95,52,1592.0590138489,24,15
"johansson t",532,1588.78982166272,374,203,1589.36969373195,229,127,1568.05073381503,55,34,1467.52812978528,54,20,1574.62273667669,36,22,1526.93603931034,145,76,1596.02729510614,300,158,1563.9118782505,74,45
"johnson s",533,1708.65239526106,181,89,1656.87165023632,126,63,1601.07738202322,31,18,1483.61571164288,24,8,1500,0,0,1614.40379568867,55,26,1681.40115071141,149,75,1543.65311124949,32,14
"jones a",534,1457.45690379239,11,2,1444.38878551357,11,2,1500,0,0,1500,0,0,1500,0,0,1500,0,0,1469.59638654965,5,1,1471.10636722223,6,1
"jones g",535,1470.1584976983,7,1,1473.05146975804,6,1,1490.14620612497,1,0,1500,0,0,1500,0,0,1489.15294331757,1,0,1474.06866867152,6,1,1491.07902239499,1,0
"jones g d",536,1480.53180803671,2,0,1473.82660003766,2,0,1500,0,0,1500,0,0,1500,0,0,1500,0,0,1481.29045676642,2,0,1500,0,0
"jonsson f",537,1384.42443768212,22,5,1446.68114081783,13,4,1475.09264410069,2,0,1445.73501961563,7,1,1500,0,0,1420.52713102662,9,1,1405.46540774442,18,4,1473.7028709405,4,1
"jouan r",538,1494.69189984109,5,1,1493.78818562113,4,1,1500,0,0,1493.32783671192,1,0,1500,0,0,1495.75083334487,1,0,1497.0859464745,3,1,1491.6666439802,2,0
"joyce m",539,1501.19862553152,6,2,1501.17191862651,6,2,1500,0,0,1500,0,0,1500,0,0,1500,0,0,1501.5728029707,6,2,1500,0,0
"jun w",540,1449.83726612103,8,1,1470.94359420537,6,1,1486.59341598939,1,0,1486.83110048972,1,0,1500,0,0,1472.49111615534,2,0,1452.81559574892,8,1,1500,0,0
"junaid r",541,1481.72881412703,2,0,1493.56269447782,1,0,1487.403315584,1,0,1500,0,0,1500,0,0,1487.63705338943,1,0,1481.5900720817,2,0,1500,0,0
"junqueira d",542,1420.45845548213,43,11,1483.15086195132,8,2,1490.39294987533,1,0,1418.58639419552,34,9,1500,0,0,1411.01148534922,35,9,1401.25742074666,35,8,1499.7390790495,8,3
"kafelnikov y",543,1609.03272138747,290,186,1612.44893086109,172,111,1581.7403730515,23,16,1595.62091433182,58,31,1620.29633432065,37,28,1621.59636966679,118,75,1609.81909777991,235,149,1593.27289404741,55,37
"kamke t",544,1527.82923361433,158,60,1500.06660828574,94,35,1489.42346977042,21,9,1505.936380805,43,16,1500,0,0,1516.71956740791,64,25,1539.69200909192,126,50,1439.70097353836,32,10
"karanusic r",545,1405.12199481485,49,11,1385.82992413062,23,4,1484.61883006097,10,4,1450.91174605007,9,1,1477.47534683394,7,2,1450.5085203219,26,7,1398.68682339921,33,7,1444.33627853773,16,4
"karatsev a",546,1462.71015699609,7,1,1457.1048416499,7,1,1500,0,0,1500,0,0,1500,0,0,1500,0,0,1459.64720175747,7,1,1500,0,0
"karbacher b",547,1476.8182945488,2,0,1487.5,1,0,1500,0,0,1490.01983832257,1,0,1500,0,0,1489.30744084328,1,0,1488.42148939367,1,0,1487.5,1,0
"karlovic i",548,1778.66307518919,594,318,1717.65109097644,356,187,1698.7598311274,100,66,1574.59195570383,114,54,1498.36980635125,24,11,1687.21053682476,238,131,1748.12484132565,501,274,1580.19665499536,93,44
"kauffmann c",549,1480.12320556396,2,0,1485.73093559435,1,0,1500,0,0,1486.1172089143,1,0,1500,0,0,1490.25673299876,1,0,1500,0,0,1480.1519071608,2,0
"kavcic b",550,1490.92728810289,106,37,1514.94652601269,46,18,1411.50869740635,11,1,1476.14445707746,48,18,1487.03267614703,1,0,1440.94452271573,60,19,1449.21341358932,76,25,1511.29216296253,30,12
"kempes e",551,1430.69015522164,24,9,1465.51539649215,13,5,1463.8142032083,3,0,1493.96679168277,8,4,1500,0,0,1457.798638345,11,4,1465.33938761818,21,9,1463.57844057293,3,0
"kendrick r",552,1437.24681231342,112,35,1470.86252650938,82,29,1423.05907323652,18,4,1433.14260205356,12,2,1500,0,0,1389.08996816672,30,6,1437.22784048643,91,31,1427.6343487924,21,4
"kennedy a",553,1469.5638100655,3,0,1480.8487410509,2,0,1486.20702040592,1,0,1500,0,0,1500,0,0,1486.36889909228,1,0,1468.62711126957,3,0,1500,0,0
"kern r",554,1470.40274088397,3,0,1500,0,0,1500,0,0,1470.91448114795,3,0,1500,0,0,1470.82181575433,3,0,1468.42729499646,3,0,1500,0,0
"ketola t",555,1451.76324002452,19,6,1468.44014948876,12,4,1475.37800025815,4,1,1500,0,0,1491.60737955047,3,1,1472.58917820037,7,2,1462.3437704801,15,5,1479.33747087668,4,1
"khachanov k",556,1615.13116823213,29,16,1570.10331229026,20,11,1500,0,0,1518.3571933703,9,5,1500,0,0,1519.14770316987,9,5,1599.23683168686,27,15,1507.72420396255,2,1
"khaddari h",557,1489.09715786514,1,0,1500,0,0,1500,0,0,1491.15171229036,1,0,1500,0,0,1490.8501692422,1,0,1488.59963437495,1,0,1500,0,0
"khalfan s",558,1463.59970701096,3,0,1460.19688146272,3,0,1500,0,0,1500,0,0,1500,0,0,1500,0,0,1463.39595005096,3,0,1500,0,0
"kicker n",559,1497.88353657114,3,1,1500,0,0,1500,0,0,1492.71724564596,3,1,1500,0,0,1492.52954492003,3,1,1497.36549148384,3,1,1500,0,0
"kiefer n",560,1657.3576136022,395,223,1696.28702620673,239,141,1562.86210199576,53,30,1587.41518632939,74,35,1554.41435783618,29,17,1622.91799508428,156,82,1651.21860185572,321,181,1613.37546774511,74,42
"kilderry p",561,1465.50196613381,3,0,1476.43059672736,2,0,1487.53285919994,1,0,1500,0,0,1500,0,0,1486.43182867723,1,0,1477.88807087411,2,0,1487.03431883644,1,0
"kim a",562,1408.8759780318,32,8,1423.87736824306,25,7,1488.27064638523,3,1,1455.84596489728,4,0,1500,0,0,1452.35965554684,7,1,1423.49920946255,24,6,1465.49944128046,8,2
"kim k",563,1424.87083198407,138,44,1428.37821881575,101,36,1417.0280380841,18,4,1445.40146890866,15,3,1478.44995506542,4,1,1392.80147939441,37,8,1415.51642267025,116,38,1425.2729284837,22,6
"kimmich m",564,1479.63030094012,3,0,1474.32092874473,3,0,1500,0,0,1500,0,0,1500,0,0,1500,0,0,1491.00188093484,1,0,1478.36443067045,2,0
"kindlmann d",565,1444.78006642572,12,1,1478.74013173661,5,0,1500,0,0,1448.48299198607,7,1,1500,0,0,1451.57002856658,7,1,1455.53200718111,5,0,1468.83411175302,7,1
"king d",566,1487.52515246607,1,0,1487.01082911494,1,0,1500,0,0,1500,0,0,1500,0,0,1500,0,0,1487.33475176839,1,0,1500,0,0
"king e",567,1488.66064843611,1,0,1486.18552397159,1,0,1500,0,0,1500,0,0,1500,0,0,1500,0,0,1488.60085024505,1,0,1500,0,0
"king k",568,1481.47832057114,2,0,1488.72185483473,1,0,1500,0,0,1490.13817159359,1,0,1500,0,0,1489.37047588035,1,0,1480.68307280204,2,0,1500,0,0
"king p",569,1429.47126848108,9,1,1425.89622577296,9,1,1500,0,0,1500,0,0,1500,0,0,1500,0,0,1436.23642444119,8,1,1487.55843562853,1,0
"king turner d",570,1445.162075715,6,0,1436.22240116582,6,0,1500,0,0,1500,0,0,1500,0,0,1500,0,0,1441.97887669706,6,0,1500,0,0
"kirillov e",571,1484.09510424977,2,0,1500,0,0,1486.25577569823,1,0,1500,0,0,1489.02339643152,1,0,1479.64542023899,2,0,1482.90923667872,2,0,1500,0,0
"klaasen r",572,1502.4188476755,8,4,1488.0198240018,5,2,1513.56892352127,3,2,1500,0,0,1500,0,0,1513.12095518849,3,2,1504.093921347,8,4,1500,0,0
"klahn b",573,1437.60292373564,22,4,1457.81909661479,17,4,1472.38322341527,3,0,1475.44952970932,2,0,1500,0,0,1448.84152635463,5,0,1447.07310914953,13,2,1458.6790342386,9,2
"klec i",574,1469.54342016447,8,2,1474.87663631915,5,1,1500,0,0,1490.95227570686,3,1,1500,0,0,1491.77618758944,3,1,1468.20180899382,8,2,1500,0,0
"klein b",575,1476.15675785371,9,2,1490.67916784147,4,1,1474.53396382892,5,1,1500,0,0,1500,0,0,1475.96532320162,5,1,1487.59193764531,4,1,1469.28694637534,5,1
"klein t",576,1488.83930574481,1,0,1500,0,0,1487.68997910794,1,0,1500,0,0,1500,0,0,1488.24005996046,1,0,1488.83409785027,1,0,1500,0,0
"klizan m",577,1616.97435824681,189,91,1561.35039895911,98,43,1464.37210211259,13,4,1642.35037443803,78,44,1500,0,0,1618.48090659195,91,48,1641.49524455926,155,77,1495.38091957567,34,14
"kloer s",578,1494.43072400955,1,0,1500,0,0,1500,0,0,1492.38412908405,1,0,1500,0,0,1493.97097122249,1,0,1493.76510611535,1,0,1500,0,0
"knippschild j",579,1430.09437552714,42,14,1428.53736482077,10,1,1518.38278796059,10,6,1447.984140916,22,7,1500,0,0,1457.08819255039,32,13,1422.16942501806,33,11,1477.23804556355,9,3
"knittel b",580,1490.00856454326,5,1,1500,0,0,1486.18160909792,1,0,1489.43463743728,4,1,1500,0,0,1485.87793948569,5,1,1495.60369451844,4,1,1487.8219371101,1,0
"knowle j",581,1397.4295537118,39,9,1422.67751872208,16,3,1462.57350995502,12,4,1429.20962908329,11,2,1500,0,0,1419.87152058506,23,6,1393.59150719361,30,6,1472.17167498392,9,3
"knowles m",582,1473.66691066384,2,0,1473.9774004463,2,0,1500,0,0,1500,0,0,1500,0,0,1500,0,0,1473.7730632567,2,0,1500,0,0
"koderisch c",583,1492.57071380027,1,0,1500,0,0,1487.43671580258,1,0,1500,0,0,1500,0,0,1491.33252090024,1,0,1491.53274995838,1,0,1500,0,0
"koellerer d",584,1461.12550726427,53,19,1486.8117146809,19,7,1448.50206490054,4,0,1478.5575786842,30,12,1500,0,0,1446.3097078562,34,12,1475.96457129663,46,17,1468.7279332238,7,2
"koenig r",585,1484.38888538071,1,0,1487.6789418663,1,0,1500,0,0,1500,0,0,1500,0,0,1500,0,0,1484.60795071776,1,0,1500,0,0
"kohlmann m",586,1469.0630202875,43,15,1429.30235630373,16,3,1470.90210048809,9,3,1515.35906640009,16,8,1499.47021730513,2,1,1505.24876499592,27,12,1470.16546565587,40,15,1471.02887728416,3,0
"kohlschreiber p",587,1736.15931218957,644,360,1652.34347562758,328,174,1672.78807486754,81,52,1741.85358138853,217,124,1533.58366122519,18,10,1760.54642457443,316,186,1752.89210006948,535,300,1617.00445763351,109,60
"kokkinakis t",588,1546.31213223994,36,13,1497.80943316426,28,10,1492.20165951489,3,1,1503.75801901839,5,2,1500,0,0,1512.13701263931,8,3,1509.6801476746,27,9,1525.16267772319,9,4
"koll h",589,1484.79970714286,1,0,1485.63726487658,1,0,1500,0,0,1500,0,0,1500,0,0,1500,0,0,1484.90686108861,1,0,1500,0,0
"kondo h",590,1476.57844751561,4,1,1473.03523755768,4,1,1500,0,0,1500,0,0,1500,0,0,1500,0,0,1475.93312536888,4,1,1500,0,0
"koning m",591,1495.81249073931,1,0,1500,0,0,1488.99006206734,1,0,1500,0,0,1500,0,0,1495.06722337353,1,0,1494.72009562416,1,0,1500,0,0
"kontinen h",592,1490.9013199079,3,1,1486.14522520682,1,0,1502.03213588178,2,1,1500,0,0,1500,0,0,1502.27605305621,2,1,1491.3114356328,3,1,1500,0,0
"kornienko i",593,1495.2356838626,1,0,1493.49923334255,1,0,1500,0,0,1500,0,0,1500,0,0,1500,0,0,1494.05074476465,1,0,1500,0,0
"korolev e",594,1513.81990807424,162,70,1579.94689345437,87,44,1428.11294599407,12,2,1459.22787479926,55,22,1451.19437853716,8,2,1419.59541149983,75,26,1511.10367124428,139,63,1476.50010256646,23,7
"korteling s",595,1490.49177599107,1,0,1500,0,0,1500,0,0,1490.9560420944,1,0,1500,0,0,1489.71140096811,1,0,1488.25850185289,1,0,1500,0,0
"kosakowski d",596,1492.40058738426,3,1,1491.63057777245,3,1,1500,0,0,1500,0,0,1500,0,0,1500,0,0,1493.14424144992,3,1,1500,0,0
"koubek s",597,1545.4269889895,359,160,1557.25980518487,190,88,1415.3549355311,26,8,1478.44900287993,122,52,1547.39855419921,21,12,1484.34656476411,169,72,1515.72852180399,297,132,1510.14617621365,62,28
"kovalik j",598,1472.46269843489,11,3,1478.5567875092,7,2,1500,0,0,1482.76401558682,4,1,1500,0,0,1482.7810997791,4,1,1490.86160327213,9,3,1474.83511931621,2,0
"kozlov s",599,1490.77220450674,9,3,1465.80538348129,3,0,1503.21060224869,6,3,1500,0,0,1500,0,0,1501.02105797739,6,3,1487.64815549366,9,3,1500,0,0
"krajan z",600,1402.03062382712,33,8,1455.82857357391,8,1,1487.14744174243,1,0,1426.1589468992,24,7,1500,0,0,1419.12858390394,25,7,1413.10573849289,30,8,1465.56778184632,3,0
"krajicek a",601,1502.22599921798,35,12,1512.84652866042,28,11,1478.83588786018,4,1,1463.81448970467,3,0,1500,0,0,1446.064202408,7,1,1484.85722067808,30,10,1497.64721177473,5,2
"krajicek r",602,1610.00842619647,74,43,1541.54300002755,37,20,1553.16299469668,19,12,1534.38348907274,13,8,1512.2980779708,5,3,1584.19334519275,37,23,1582.08950347474,54,30,1567.92262779528,20,13
"krajinovic f",603,1460.24408472889,38,12,1457.48466115685,19,5,1493.20969890223,1,0,1488.95788703519,18,7,1500,0,0,1482.38148328106,19,7,1486.71594944115,30,11,1440.37369698172,8,1
"kralert p",604,1477.33877815118,4,1,1500.19782632622,2,1,1500,0,0,1475.77593609507,2,0,1500,0,0,1474.71947266391,2,0,1473.59242867638,2,0,1500.3296011959,2,1
"kratochvil m",605,1466.44763766231,159,70,1490.85212805901,82,36,1512.10226478932,21,11,1480.73913685175,45,20,1440.64294368336,11,3,1465.3140783108,77,34,1462.03690920589,136,60,1485.65566225596,23,10
"kravchuk k",606,1439.96049360521,19,5,1446.70173798976,12,3,1463.80087686227,3,0,1500.6933332227,2,1,1499.15996673282,2,1,1472.52367603021,7,2,1446.77022156709,17,5,1482.44969107417,2,0
"krawietz k",607,1474.89737950297,3,0,1500,0,0,1500,0,0,1467.31349075914,3,0,1500,0,0,1470.10566206382,3,0,1475.15256149508,3,0,1500,0,0
"kroslak j",608,1437.6130897267,18,6,1468.83463870651,13,5,1500,0,0,1475.82692918846,4,1,1487.5,1,0,1465.16945237682,5,1,1439.61086960646,16,5,1500,2,1
"krstin p",609,1481.86106191978,2,0,1482.43561660002,2,0,1500,0,0,1500,0,0,1500,0,0,1500,0,0,1480.32471832212,2,0,1500,0,0
"krueger m",610,1485.67942904752,1,0,1500,0,0,1486.34864488453,1,0,1500,0,0,1500,0,0,1486.33823889686,1,0,1485.98810359033,1,0,1500,0,0
"kubler j",611,1501.3301639988,3,1,1494.53565669708,1,0,1500,0,0,1499.82118800138,2,1,1500,0,0,1501.25455784986,2,1,1504.64935825176,2,1,1489.43178305363,1,0
"kubot l",612,1514.63158830797,198,80,1440.53097524618,93,32,1528.74070236698,23,12,1514.83868527716,81,36,1487.03493699592,1,0,1542.94304684394,105,48,1476.5008080144,158,60,1524.69633347262,40,20
"kucera k",613,1552.61900883571,172,86,1583.056126368,98,54,1523.35932067077,26,14,1418.01980283974,35,12,1494.05560524809,13,6,1482.19356551059,74,32,1523.88202308475,138,70,1532.25588761368,34,16
"kucera v",614,1515.09787461904,2,1,1512.0355029917,2,1,1500,0,0,1500,0,0,1500,0,0,1500,0,0,1514.30460908328,2,1,1500,0,0
"kudla d",615,1467.74468478387,87,29,1432.02683957598,53,14,1512.43468211018,25,13,1465.9195683438,9,2,1500,0,0,1504.21573854722,34,15,1467.038162605,66,22,1463.6503661798,21,7
"kudryavtsev a",616,1454.21264858675,20,5,1476.8371829775,15,5,1479.01334384829,2,0,1486.70769749551,1,0,1475.97544548967,2,0,1452.00308951562,5,0,1464.71075132349,15,4,1470.47614605709,5,1
"kuerten g",617,1495.45451091976,306,205,1571.65589613119,138,87,1513.46454842073,5,3,1572.19002551749,143,103,1549.90592660622,20,12,1558.90549860026,168,118,1503.35243855321,242,162,1606.45025426943,64,43
"kukushkin m",618,1547.69176992439,207,84,1552.85358967875,131,59,1461.07697032303,18,5,1455.40060468897,54,19,1476.07557030242,4,1,1460.77488837497,76,25,1535.57361204956,171,70,1487.94224259823,36,14
"kulti n",619,1443.87161364371,5,0,1477.25226343296,2,0,1487.5,1,0,1476.30322947157,2,0,1500,0,0,1464.17857388682,3,0,1453.5169095613,4,0,1487.5,1,0
"kumantsov a",620,1476.500255979,2,0,1474.90366791945,2,0,1500,0,0,1500,0,0,1500,0,0,1500,0,0,1476.79381156534,2,0,1500,0,0
"kumar s",621,1487.5,1,0,1487.5,1,0,1500,0,0,1500,0,0,1500,0,0,1500,0,0,1487.5,1,0,1500,0,0
"kunitsyn i",622,1420.37273393317,232,85,1432.34312219143,139,48,1432.77557554668,37,12,1434.66979033138,29,8,1584.58404018503,27,17,1450.19954932425,93,37,1428.90770571337,200,77,1417.32601489497,32,8
"kutac r",623,1487.33904848237,1,0,1500,0,0,1500,0,0,1487.95574924376,1,0,1500,0,0,1486.81567608894,1,0,1487.90316918526,1,0,1500,0,0
"kutrovsky d",624,1514.29344875462,3,2,1513.76901512536,3,2,1500,0,0,1500,0,0,1500,0,0,1500,0,0,1514.0220059145,3,2,1500,0,0
"kutsenko v",625,1465.36262626953,10,3,1462.13675274114,8,2,1500,0,0,1502.29395585946,2,1,1500,0,0,1500.48126620257,2,1,1467.9838362771,7,2,1487.27467604415,3,1
"kuzmanov d",626,1489.36191443618,1,0,1490.10528422862,1,0,1500,0,0,1500,0,0,1500,0,0,1500,0,0,1489.09220513322,1,0,1500,0,0
"kuznetsov a",627,1428.80180328324,26,6,1398.50801213627,19,3,1490.40971413937,5,2,1497.90701514556,2,1,1500,0,0,1499.66726177166,7,3,1433.04342605585,20,5,1472.08619303142,6,1
"kuznetsov al",628,1431.72508409068,21,5,1458.48289638703,12,3,1450.88532153303,6,1,1484.69380061357,3,1,1500,0,0,1449.00556774239,9,2,1441.27564329835,18,5,1466.01315119627,3,0
"kuznetsov an",629,1678.67318961592,121,54,1614.38814859945,56,27,1492.74215811644,15,6,1540.17947877717,50,21,1500,0,0,1577.84321500217,65,27,1588.49187983426,90,37,1618.76908056499,31,17
"kyrgios n",630,1854.41781378154,113,71,1773.67902305406,68,43,1592.35477600438,15,10,1652.11672446949,30,18,1500,0,0,1722.98016674382,45,28,1809.55649620161,74,46,1676.67567938728,39,25
"laaksonen h",631,1450.47482938874,20,5,1461.72727477391,7,1,1500,0,0,1467.90649148149,13,4,1500,0,0,1468.63465026934,13,4,1444.58327984852,20,5,1500,0,0
"labadze i",632,1493.76457316947,117,40,1443.55141356323,49,15,1480.73211077969,14,5,1458.46902567423,50,19,1475.99253898295,4,1,1487.16527187295,68,25,1440.80104519074,97,33,1478.43003770831,20,7
"lacko l",633,1496.53195731289,165,61,1468.82099213713,118,47,1475.24806234488,30,12,1429.68793655092,16,2,1490.04573106368,1,0,1465.72705317563,47,14,1497.19758495551,126,50,1451.24366913034,39,11
"lajola d",634,1487.5,1,0,1487.5,1,0,1500,0,0,1500,0,0,1500,0,0,1500,0,0,1487.5,1,0,1500,0,0
"lajovic d",635,1597.93379200781,122,51,1516.98205783941,48,17,1457.14694799962,7,1,1580.6404042833,67,33,1500,0,0,1563.87975256051,74,34,1595.53734085572,103,43,1497.73738983594,19,8
"lama g",636,1486.44035946571,1,0,1500,0,0,1500,0,0,1488.4345209459,1,0,1500,0,0,1487.84283484604,1,0,1487.13791858021,1,0,1500,0,0
"lamasine t",637,1488.17441505296,4,1,1500,0,0,1490.78572189696,1,0,1492.57287224314,3,1,1500,0,0,1486.33974425401,4,1,1491.32832155749,3,1,1492.91422585246,1,0
"lammer m",638,1479.52007343188,22,6,1507.8318058211,13,5,1500,0,0,1445.36538084564,8,1,1489.70018752045,1,0,1439.04862610053,9,1,1469.9496230041,19,5,1497.89888288051,3,1
"landsberg j",639,1488.19303627943,1,0,1500,0,0,1487.5,1,0,1500,0,0,1500,0,0,1488.41516063142,1,0,1488.3218158495,1,0,1500,0,0
"langer n",640,1498.55945978174,3,1,1488.96495828995,1,0,1500,0,0,1505.79536323254,2,1,1500,0,0,1506.35488145101,2,1,1498.2810329859,3,1,1500,0,0
"lapentti g",641,1416.29008285503,29,7,1466.20625817339,17,6,1484.9465443008,3,1,1432.2072402356,9,0,1500,0,0,1421.06962365641,12,1,1430.66868519169,26,7,1467.94976256889,3,0
"lapentti n",642,1503.67688043394,367,180,1500.69665210506,141,68,1482.94778435153,18,8,1525.46956607039,182,93,1469.478634957,26,11,1489.18316506603,226,112,1540.83348225117,305,149,1466.67054783618,62,31
"lareau s",643,1444.88876066737,26,9,1460.69626764664,19,7,1488.86716952564,5,2,1474.13046844236,2,0,1500,0,0,1465.92021879094,7,2,1456.47814375101,22,8,1477.95562030269,4,1
"larkham t",644,1476.7921432929,7,1,1500.2586271378,4,1,1489.11088974371,1,0,1478.3080718331,2,0,1500,0,0,1470.79849576472,3,0,1492.89867021695,1,0,1472.75217354298,6,1
"larose s",645,1519.3779739294,12,5,1505.76718571512,12,5,1500,0,0,1500,0,0,1500,0,0,1500,0,0,1518.27393609772,12,5,1500,0,0
"larsson m",646,1536.54157842794,57,31,1558.55754941959,35,21,1499.34093574909,12,6,1487.84909293593,10,4,1500,0,0,1485.01776427558,22,10,1541.41151773727,48,27,1499.08013608293,9,4
"lazov a",647,1490.83877278054,1,0,1488.70930457978,1,0,1500,0,0,1500,0,0,1500,0,0,1500,0,0,1490.69111970129,1,0,1500,0,0
"ledovskikh m",648,1441.36017057843,17,4,1478.43914609358,8,2,1460.45166249912,5,1,1486.23919952208,1,0,1487.10708008399,3,1,1449.83271802511,9,2,1441.2981333362,17,4,1500,0,0
"lee h t",649,1556.93188589739,265,118,1558.40779261646,181,80,1505.39004347497,36,17,1508.63603458356,46,21,1475.44952970932,2,0,1531.18083867495,84,38,1552.6575039186,214,96,1509.92344062561,51,22
"lee m",650,1415.07929094054,46,15,1421.84884094178,16,3,1482.80585242359,25,11,1465.71954970954,5,1,1500,0,0,1456.94919590647,30,12,1430.53308994682,35,12,1455.17113641457,11,3
"lejnieks k",651,1506.90244903953,2,1,1500,0,0,1500,0,0,1500,0,0,1499.61165120918,2,1,1506.99168718302,2,1,1506.08024018887,2,1,1500,0,0
"lemke j",652,1492.90316928867,1,0,1485.26678976019,1,0,1500,0,0,1500,0,0,1500,0,0,1500,0,0,1493.01955565208,1,0,1500,0,0
"lestienne c",653,1486.55841035301,1,0,1500,0,0,1500,0,0,1486.60775659429,1,0,1500,0,0,1486.79383054223,1,0,1486.28212318316,1,0,1500,0,0
"levine i",654,1474.71266660372,2,0,1487.04783345211,1,0,1487.5,1,0,1500,0,0,1500,0,0,1487.26066603329,1,0,1473.90205176013,2,0,1500,0,0
"levine j",655,1489.95421596802,93,30,1460.97077828802,63,19,1475.57444647827,23,10,1449.44764521127,7,1,1500,0,0,1457.77805955988,30,11,1454.4599510507,70,21,1490.13069950992,23,9
"levinsky j",656,1484.43809331697,1,0,1500,0,0,1500,0,0,1483.27612978989,1,0,1500,0,0,1484.70319518403,1,0,1484.0101867819,1,0,1500,0,0
"levy h",657,1350.6999937525,119,39,1373.58636972075,68,23,1461.37772523438,16,6,1423.14327140374,30,9,1463.96146627465,5,1,1395.93159109474,51,16,1368.02080118612,102,35,1415.94823423806,17,4
"li z",658,1463.6763978986,5,0,1460.37050642826,5,0,1500,0,0,1500,0,0,1500,0,0,1500,0,0,1462.13151348394,5,0,1500,0,0
"lindahl n",659,1451.67711356904,9,1,1454.07929391006,8,1,1500,0,0,1488.84417852554,1,0,1500,0,0,1489.64429551724,1,0,1460.3919980924,7,1,1483.56784137315,2,0
"lindell c",660,1450.35806261422,10,2,1486.28271727368,1,0,1500,0,0,1460.45152656003,9,2,1500,0,0,1459.09886539701,9,2,1454.71555417838,9,2,1497.05243734664,1,0
"linzer m",661,1478.93453345996,2,0,1500,0,0,1500,0,0,1477.548375522,2,0,1500,0,0,1478.89490693223,2,0,1478.0706601551,2,0,1500,0,0
"lipsky s",662,1485.09475279479,1,0,1500,0,0,1487.81232360059,1,0,1500,0,0,1500,0,0,1487.32073510276,1,0,1485.37191264542,1,0,1500,0,0
"lisnard j",663,1414.96047411363,117,40,1426.68844748089,58,21,1468.32163590239,5,1,1415.81194700011,52,17,1500.09251999585,2,1,1414.80227363374,59,19,1412.06690454606,90,31,1453.89346500847,27,9
"liukko v",664,1498.92974983855,4,2,1498.92974983855,4,2,1500,0,0,1500,0,0,1500,0,0,1500,0,0,1497.84869771671,4,2,1500,0,0
"ljubicic i",665,1671.3858870181,647,386,1635.81630374282,373,229,1532.89938877015,50,24,1686.81109836221,155,88,1629.77130099326,69,45,1678.33475132322,274,157,1662.8651083387,548,337,1587.330734278,99,49
"llodra m",666,1624.89916734712,395,182,1608.14381980109,238,108,1607.8509060924,73,44,1493.72349077115,57,20,1451.95259621612,27,10,1596.84589449714,157,74,1642.50996662832,310,148,1502.94361357885,85,34
"logtens p",667,1485.53567134728,2,0,1500,0,0,1476.67850052586,2,0,1500,0,0,1500,0,0,1478.51834487989,2,0,1484.61613182211,2,0,1500,0,0
"lojda d",668,1492.35139592231,1,0,1489.58888444614,1,0,1500,0,0,1500,0,0,1500,0,0,1500,0,0,1500,0,0,1489.18201133663,1,0
"lokoli l",669,1457.046740401,4,0,1464.71101190775,3,0,1500,0,0,1486.91809611539,1,0,1500,0,0,1486.53243187875,1,0,1478.45600492834,2,0,1472.50711432688,2,0
"londero j i",670,1477.82535673618,2,0,1500,0,0,1500,0,0,1475.19027667661,2,0,1500,0,0,1477.21936788779,2,0,1478.39169079106,2,0,1500,0,0
"lopes h",671,1491.14892487191,1,0,1500,0,0,1500,0,0,1490.60385596838,1,0,1500,0,0,1490.22367531396,1,0,1490.53346296094,1,0,1500,0,0
"lopez f",672,1709.22524845179,785,414,1692.52128011516,440,229,1658.15546759942,96,61,1627.4211231468,219,110,1510.02812254153,30,14,1657.30384732972,345,185,1676.8244384148,636,326,1684.76222165873,149,88
"lopez jaen m a",673,1507.52131662733,3,1,1500,0,0,1500,0,0,1504.25583244541,3,1,1500,0,0,1503.43407389228,3,1,1494.47649556841,1,0,1508.59661962137,2,1
"lopez m",674,1473.02073214467,52,21,1497.70831538688,3,1,1493.30646161167,3,1,1477.26368000068,46,19,1500,0,0,1463.50786482068,49,20,1488.76551319596,47,20,1468.63372698441,5,1
"lopez moron a",675,1413.8669942683,10,1,1475,2,0,1500,0,0,1435.60435189135,8,1,1500,0,0,1435.31211785025,8,1,1425.36861662883,9,1,1487.5,1,0
"lopez perez e",676,1493.85274533436,1,0,1500,0,0,1500,0,0,1492.61122395272,1,0,1500,0,0,1491.83877429262,1,0,1494.33085221855,1,0,1500,0,0
"lorenzi p",677,1598.53886604053,183,67,1520.05846736135,73,24,1401.26953402459,17,3,1568.2469068525,93,40,1500,0,0,1524.17684448679,110,43,1588.35347913207,157,63,1404.36022288418,26,4
"lu h",678,1504.72260864371,2,1,1503.83593764602,2,1,1500,0,0,1500,0,0,1500,0,0,1500,0,0,1504.38908684437,2,1,1500,0,0
"lu y",679,1454.49153066517,4,0,1453.46552585274,4,0,1500,0,0,1500,0,0,1500,0,0,1500,0,0,1452.75529753629,4,0,1500,0,0
"lu y h",680,1643.4402722063,324,133,1595.07187484663,242,101,1553.86048160562,59,27,1446.79390542887,22,5,1488.78130638276,1,0,1548.41791574284,82,32,1648.17735752651,260,111,1464.54259664196,64,22
"luczak a",681,1519.06502149248,1,1,1500,0,0,1500,0,0,1519.69966957411,1,1,1500,0,0,1518.39931011154,1,1,1519.09765708322,1,1,1500,0,0
"luczak p",682,1434.74467038196,115,35,1439.48202543423,54,16,1515.72091564878,8,4,1401.32536927059,53,15,1500,0,0,1425.51480139382,61,19,1436.6126183564,92,29,1431.05980314126,23,6
"lukaev r",683,1486.18206238166,1,0,1484.84218403415,1,0,1500,0,0,1500,0,0,1500,0,0,1500,0,0,1500,0,0,1486.33099399538,1,0
"luncanu p a",684,1482.01158508867,2,0,1490.41823637648,1,0,1500,0,0,1487.1450743739,1,0,1500,0,0,1487.56644147184,1,0,1481.05101898511,2,0,1500,0,0
"luque d",685,1487.5,1,0,1500,0,0,1500,0,0,1487.5,1,0,1500,0,0,1487.5,1,0,1487.5,1,0,1500,0,0
"luxa p",686,1427.31777656855,7,0,1446.38722306261,5,0,1478.98143414785,2,0,1500,0,0,1500,0,0,1477.55071107627,2,0,1434.55079150155,6,0,1488.34801518559,1,0
"luzzi f",687,1455.51860578079,44,16,1466.9097093757,11,3,1500,0,0,1477.34707925975,31,13,1474.41653974177,2,0,1454.34793717488,33,13,1474.97870445604,38,15,1462.19960314965,6,1
"maamoun k",688,1489.26217788843,1,0,1487.56258284047,1,0,1500,0,0,1500,0,0,1500,0,0,1500,0,0,1488.77425538785,1,0,1500,0,0
"machado r",689,1401.34895536311,50,13,1430.58975679347,11,1,1487.44960714854,1,0,1426.67634177573,38,12,1500,0,0,1420.15697933166,39,12,1422.37971246897,38,11,1429.55426404902,12,2
"mackin a",690,1407.53608156268,11,0,1487.26533368739,1,0,1431.28175500871,6,0,1482.49380322189,2,0,1475.19810409317,2,0,1408.80187780749,10,0,1438.14148580867,6,0,1449.09660289904,5,0
"maclagan m",691,1472.10234338906,2,0,1484.87972146162,1,0,1487.46879591686,1,0,1500,0,0,1500,0,0,1487.38290027092,1,0,1484.692863964,1,0,1487.5,1,0
"macphie b",692,1502.45802055879,2,1,1502.45802055879,2,1,1500,0,0,1500,0,0,1500,0,0,1500,0,0,1502.23343674415,2,1,1500,0,0
"maden y",693,1495.4540962866,1,0,1494.77217599079,1,0,1500,0,0,1500,0,0,1500,0,0,1500,0,0,1495.06325687,1,0,1500,0,0
"mahut n",694,1669.38710128682,349,156,1549.45975691786,186,75,1708.44179477346,98,63,1460.70057169692,47,14,1419.14782250713,18,4,1690.57159741481,163,81,1623.52006927442,279,130,1539.30438266921,70,26
"malcor o",695,1471.8901652205,2,0,1500,0,0,1500,0,0,1472.61798124181,2,0,1500,0,0,1471.85202032814,2,0,1473.05157347433,2,0,1500,0,0
"malisse x",696,1565.60187734075,516,266,1523.08652636626,313,157,1662.42586702393,79,50,1461.09737439839,91,40,1541.54714557092,33,19,1606.52404449635,203,109,1566.3058652831,415,211,1537.63649708793,101,55
"mamiit c",697,1393.8015618162,95,30,1414.3732328307,74,25,1437.46129366069,12,3,1449.42886148186,9,2,1500,0,0,1399.67518028326,21,5,1401.57721508698,81,27,1431.14134634444,14,3
"mankad h",698,1461.06585566257,3,0,1473.38645222835,2,0,1487.78472145478,1,0,1500,0,0,1500,0,0,1485.64632933532,1,0,1461.97442614197,3,0,1500,0,0
"mannarino a",699,1602.10262525586,239,103,1552.39978578044,149,63,1579.99285982546,47,26,1485.32760549634,42,14,1487.04704667514,1,0,1596.20738741113,90,40,1588.52861621244,194,85,1521.11810778757,45,18
"manta l",700,1421.99434766173,16,4,1481.0822383559,10,4,1462.08219715363,3,0,1464.97533958843,3,0,1500,0,0,1427.80362730433,6,0,1431.78489200857,15,4,1487.5,1,0
"mantilla f",701,1555.7097686071,239,123,1509.02910119121,73,33,1463.01734052681,7,2,1600.30208323763,151,86,1450.94421859033,8,2,1563.6203320252,166,90,1561.96069237518,207,111,1469.89848179039,32,12
"marach o",702,1448.44640502813,45,16,1467.73751160652,11,3,1486.96731614586,1,0,1475.4384057423,30,12,1486.46277636986,3,1,1460.41643348577,34,13,1472.97828371247,40,16,1442.0868951794,5,0
"marcaccio g",703,1497.11693486376,5,2,1487.47022610561,1,0,1500,0,0,1510.28218395231,4,2,1500,0,0,1507.92047769816,4,2,1496.94721192709,5,2,1500,0,0
"marcan d",704,1484.64506123682,2,0,1481.11891762803,2,0,1500,0,0,1500,0,0,1500,0,0,1500,0,0,1484.10018956058,2,0,1500,0,0
"march o",705,1486.00709435789,1,0,1486.24195555849,1,0,1500,0,0,1500,0,0,1500,0,0,1500,0,0,1500,0,0,1486.42237552633,1,0
"marchenko i",706,1526.09350998196,112,45,1542.00366133996,80,36,1453.10459682223,17,6,1432.47297559213,15,3,1500,0,0,1418.33909133947,32,9,1493.16802470358,89,37,1482.45225538994,23,8
"marin j a",707,1379.12582932803,83,27,1424.31543230155,9,1,1486.61761473855,1,0,1396.15746170775,73,26,1500,0,0,1384.15447888438,74,26,1394.12949430712,76,27,1425.85499653053,7,0
"marin l",708,1490.62463317365,1,0,1500,0,0,1500,0,0,1490.58867241758,1,0,1500,0,0,1490.09219799952,1,0,1490.9181954343,1,0,1500,0,0
"marques n",709,1488.96081715722,1,0,1500,0,0,1500,0,0,1487.5,1,0,1500,0,0,1487.5,1,0,1488.28924682315,1,0,1500,0,0
"marrai m",710,1488.10747508079,1,0,1500,0,0,1500,0,0,1490.72244483411,1,0,1500,0,0,1489.7549835662,1,0,1488.07389261845,1,0,1500,0,0
"marray j",711,1474.91188662808,12,4,1489.89451169566,1,0,1475.1826406322,11,4,1500,0,0,1500,0,0,1481.79246669653,11,4,1500.66710650237,9,4,1471.77907884307,3,0
"marrero d",712,1466.80671069262,9,3,1500,0,0,1500,0,0,1469.13994764639,9,3,1500,0,0,1467.25742073389,9,3,1461.25868987801,7,2,1506.01966891941,2,1
"martelli m",713,1490.55042498278,5,2,1502.36625032467,2,1,1500,0,0,1488.68187583629,3,1,1500,0,0,1487.89384986485,3,1,1489.52087567006,5,2,1500,0,0
"marterer m",714,1470.33571613905,4,0,1477.84227195501,2,0,1486.83944688317,1,0,1494.12469395899,1,0,1500,0,0,1482.68806989176,2,0,1468.93615400771,4,0,1500,0,0
"marti j",715,1451.50792690962,13,2,1493.29108991456,2,0,1497.10869008068,2,1,1444.14119467164,9,1,1500,0,0,1446.13809308587,11,2,1458.54033388308,12,2,1487.5,1,0
"marti y",716,1477.25177427944,7,2,1500,0,0,1500,0,0,1477.19115454719,7,2,1500,0,0,1474.86202520168,7,2,1475.4843082616,7,2,1500,0,0
"martin a",717,1557.12754824728,415,187,1376.6512247814,138,50,1421.2286048826,18,4,1595.61177967872,253,132,1454.21611350591,6,1,1584.08619705831,277,137,1544.11681227392,361,167,1446.54758882716,54,20
"martin d",718,1494.34644549258,1,0,1491.74689572227,1,0,1500,0,0,1500,0,0,1500,0,0,1500,0,0,1492.76243943241,1,0,1500,0,0
"martin f",719,1476.39480413952,2,0,1485.45185633867,1,0,1487.7199070511,1,0,1500,0,0,1500,0,0,1487.54578976665,1,0,1476.66369912644,2,0,1500,0,0
"martin t",720,1582.27010552249,138,76,1578.475711002,88,51,1565.58756701624,22,14,1481.00581993259,28,11,1500,0,0,1548.52181198743,50,25,1566.56462572429,91,48,1588.34134767894,47,28
"massa e",721,1467.67959584897,24,8,1493.33252890453,5,2,1487.0274228142,1,0,1471.76002986041,18,6,1500,0,0,1460.56840543013,19,6,1479.10579456248,22,8,1476.6438927794,2,0
"massu n",722,1458.13471978308,431,217,1495.30693802604,153,65,1452.15040289703,17,6,1481.98713448359,244,139,1477.15059726155,17,7,1455.02808099001,278,152,1484.99015679451,371,194,1438.58552902162,60,23
"mathieu p",723,1569.77990951023,554,269,1502.8946900537,244,112,1501.03556120114,53,22,1589.57769331465,208,107,1537.92489401124,49,28,1589.95352037398,310,157,1572.47284999517,460,224,1522.4194877338,94,45
"matias n",724,1489.4098286599,1,0,1500,0,0,1500,0,0,1490.323602143,1,0,1500,0,0,1490.06380654932,1,0,1489.53860672649,1,0,1500,0,0
"matkowski m",725,1477.79859279154,2,0,1500,0,0,1500,0,0,1480.98191027638,2,0,1500,0,0,1478.5785991878,2,0,1477.55804268454,2,0,1500,0,0
"matos gil i",726,1488.62232337375,2,0,1500,0,0,1500,0,0,1485.0625476364,2,0,1500,0,0,1485.98418243369,2,0,1486.26157909164,2,0,1500,0,0
"matosevic m",727,1519.07646448382,154,61,1551.344763308,109,46,1482.36960091139,19,7,1463.03993751544,26,8,1500,0,0,1480.82417582643,45,15,1525.74711180765,133,58,1430.72009963015,21,3
"matsui t",728,1513.94798627519,4,2,1509.83030232487,4,2,1500,0,0,1500,0,0,1500,0,0,1500,0,0,1513.55506606561,4,2,1500,0,0
"matsukevitch d",729,1487.77095793116,4,1,1500,0,0,1500,0,0,1489.39092027025,1,0,1495.3320424704,3,1,1485.28233517153,4,1,1486.98412990933,4,1,1500,0,0
"mayer f",730,1663.08958318645,429,214,1610.33785045814,211,98,1656.8173187236,52,33,1546.83762463749,158,80,1479.84496230551,8,3,1657.59373294525,218,116,1679.79963952905,354,178,1524.61224012303,75,36
"mayer l",731,1592.06822389436,250,116,1531.82590633487,107,43,1510.87007722942,28,13,1600.83370605853,115,60,1500,0,0,1598.3738165182,143,73,1586.68302625591,196,90,1570.87003567771,54,26
"mazarakis v",732,1467.41913355632,5,0,1486.3169324723,2,0,1500,0,0,1476.58384816275,3,0,1500,0,0,1476.20188924354,3,0,1466.84423587263,5,0,1500,0,0
"mcclune m",733,1500.38926254809,3,1,1497.69412622131,3,1,1500,0,0,1500,0,0,1500,0,0,1500,0,0,1503.84611669789,2,1,1488.62481331532,1,0
"mcdonald m",734,1452.29468904705,4,0,1464.47070580677,3,0,1488.99857504757,1,0,1500,0,0,1500,0,0,1487.87301353375,1,0,1462.74953242548,3,0,1487.5,1,0
"mcgee j",735,1467.27654449069,3,0,1467.73707697068,3,0,1500,0,0,1500,0,0,1500,0,0,1500,0,0,1478.96824943242,2,0,1487.16363744255,1,0
"mecir m",736,1488.8134700525,4,1,1493.64115417876,3,1,1500,0,0,1486.570530236,1,0,1500,0,0,1487.19778248129,1,0,1499.85522098556,3,1,1486.73079776418,1,0
"medvedev a",737,1497.3414598746,61,29,1470.19560059969,18,6,1475.9970540356,4,1,1528.23632006494,37,21,1499.56774126876,2,1,1502.69231859205,43,23,1514.27598318588,51,25,1477.03395081526,10,4
"medvedev d",738,1523.07609135115,10,5,1522.09081550783,5,3,1499.97797733897,2,1,1489.32395458826,3,1,1500,0,0,1488.82199893197,5,2,1521.8336236263,10,5,1500,0,0
"meffert d",739,1495.16362995454,13,5,1491.59964401298,7,3,1493.89184365837,3,1,1497.04219077829,3,1,1500,0,0,1495.02115065663,6,2,1498.09858113225,12,5,1488.89128790241,1,0
"meister n",740,1492.59469817831,1,0,1488.28008638879,1,0,1500,0,0,1500,0,0,1500,0,0,1500,0,0,1491.43426794787,1,0,1500,0,0
"mektic n",741,1469.42273156045,8,2,1477.77611337392,2,0,1500,0,0,1495.59746897793,5,2,1486.49437981599,1,0,1486.08753499593,6,2,1469.85278850769,8,2,1500,0,0
"meligeni f",742,1535.12718994909,124,56,1517.59461038458,42,19,1474.22995317832,4,1,1523.51232969984,75,36,1472.23939750009,3,0,1501.25212547683,82,37,1530.04693216931,105,49,1469.08232887777,19,7
"mello r",743,1445.60653267812,137,51,1439.66072882645,77,30,1432.42403854761,9,1,1476.11061565961,49,20,1474.31805202059,2,0,1441.6036813953,60,21,1440.34307039153,113,44,1433.67887118637,24,7
"melo d",744,1475.65586577892,5,1,1484.51722534577,1,0,1500,0,0,1487.65845588033,4,1,1500,0,0,1486.24676168401,4,1,1476.2052576153,5,1,1500,0,0
"melzer g",745,1467.87076811581,22,6,1453.92735328644,5,0,1500,0,0,1494.37919461922,17,6,1500,0,0,1490.61977694013,17,6,1474.96418138081,21,6,1485.16157024414,1,0
"melzer j",746,1609.5047957812,623,323,1573.33544651567,320,161,1581.29711868235,70,38,1578.7277297643,220,119,1459.39099331902,13,5,1593.65198099415,303,162,1595.26331779504,513,264,1595.02336461297,110,59
"menendez maceiras a",747,1451.87760924451,8,1,1468.70241078075,3,0,1472.05829567511,2,0,1486.31744708588,3,1,1500,0,0,1462.74934209612,5,1,1462.68453999982,6,1,1473.08211870828,2,0
"mergea f",748,1502.6277057541,4,2,1500,0,0,1500.04196309118,2,1,1500.62979156311,2,1,1500,0,0,1500.74468866752,4,2,1500.82290706227,4,2,1500,0,0
"mertens y",749,1486.14022895596,3,1,1487.04989861207,3,1,1500,0,0,1500,0,0,1500,0,0,1500,0,0,1484.85729351014,3,1,1500,0,0
"mertinak m",750,1445.59518914436,15,4,1500,0,0,1481.57916574244,6,2,1468.69603487169,8,2,1486.2202527014,1,0,1442.56140094389,15,4,1450.76765140899,14,4,1488.30428867075,1,0
"mertl j",751,1505.60339883961,2,1,1500,0,0,1500,0,0,1502.25786856717,2,1,1500,0,0,1503.2259053637,2,1,1503.94335842013,2,1,1500,0,0
"mesaros k",752,1491.53300106824,1,0,1488.61658848424,1,0,1500,0,0,1500,0,0,1500,0,0,1500,0,0,1490.71454597636,1,0,1500,0,0
"michon a",753,1506.66205942058,2,1,1500,0,0,1500,0,0,1503.59095993769,2,1,1500,0,0,1504.09623484316,2,1,1500,0,0,1503.31680299633,2,1
"middelkoop m",754,1489.78720510181,1,0,1500,0,0,1486.78578056303,1,0,1500,0,0,1500,0,0,1489.79576339596,1,0,1489.14090154065,1,0,1500,0,0
"miedler l",755,1490.28256605008,1,0,1490.13659160868,1,0,1500,0,0,1500,0,0,1500,0,0,1500,0,0,1491.08212600829,1,0,1500,0,0
"miketa d",756,1489.64686241562,1,0,1500,0,0,1500,0,0,1488.8067291179,1,0,1500,0,0,1488.5882366818,1,0,1488.77722167567,1,0,1500,0,0
"milligan l",757,1485.79114608456,2,0,1487.03429066708,1,0,1487.05047029068,1,0,1500,0,0,1500,0,0,1495.57373468296,1,0,1487.95340749584,1,0,1491.4141729359,1,0
"millman j",758,1605.84173951436,61,25,1538.91481141198,49,20,1528.03366553392,9,5,1467.76085052438,3,0,1500,0,0,1527.94415035045,12,5,1577.20048932408,48,20,1507.69188770276,13,5
"millot v",759,1467.15691109959,21,5,1471.31012359185,17,5,1486.52275257458,1,0,1466.74727678053,3,0,1500,0,0,1454.66038375394,4,0,1467.80251228101,16,4,1476.98784996137,5,1
"milojevic n",760,1505.42404176161,2,1,1500,0,0,1500,0,0,1501.2531227255,2,1,1500,0,0,1503.16394552852,2,1,1505.17155530826,2,1,1500,0,0
"mina g",761,1486.92563772354,5,1,1500,0,0,1500,0,0,1477.46542598306,5,1,1500,0,0,1479.67708352326,5,1,1485.4622174492,4,1,1498.26344678851,1,0
"minar i",762,1481.91013944307,96,33,1531.63001735712,42,18,1442.40127107816,13,3,1447.95748259142,39,12,1475.88878381323,2,0,1413.32321263928,54,15,1475.56844106837,80,29,1450.05085708242,16,4
"minar j",763,1486.57079401136,3,0,1483.05384050681,3,0,1500,0,0,1500,0,0,1500,0,0,1500,0,0,1490.02707373832,2,0,1485.88314738839,1,0
"miranda i",764,1466.52528248292,19,7,1458.88949398452,9,2,1510.16310149021,3,2,1492.62754790103,7,3,1500,0,0,1498.93977852174,10,5,1483.59357948967,16,7,1470.35334101464,3,0
"mirnegg m",765,1491.77193236833,1,0,1500,0,0,1500,0,0,1488.93568746979,1,0,1500,0,0,1490.06937629923,1,0,1490.89336392337,1,0,1500,0,0
"mirnyi m",766,1533.63441338938,402,201,1511.7917088912,220,116,1583.60854890716,51,28,1460.64712706857,82,32,1521.96710046882,49,25,1538.68277497704,182,85,1518.60599117047,339,171,1528.72911404687,63,30
"mitchell b",767,1455.21807087344,5,0,1453.02158053196,5,0,1500,0,0,1500,0,0,1500,0,0,1500,0,0,1469.24741274563,3,0,1479.66229593618,2,0
"miyao j",768,1475.47928046289,2,0,1478.01701483408,2,0,1500,0,0,1500,0,0,1500,0,0,1500,0,0,1476.31141786307,2,0,1500,0,0
"mlynarik z",769,1490.55429202359,1,0,1488.8597992495,1,0,1500,0,0,1500,0,0,1500,0,0,1500,0,0,1490.3673674463,1,0,1500,0,0
"mmoh m",770,1472.9976987156,3,0,1470.05713250813,3,0,1500,0,0,1500,0,0,1500,0,0,1500,0,0,1481.44416553365,2,0,1493.12864523662,1,0
"moeller m",771,1490.33375236395,1,0,1500,0,0,1500,0,0,1488.02866613732,1,0,1500,0,0,1489.15056101691,1,0,1488.97116480875,1,0,1500,0,0
"moldovan i",772,1455.8837385419,6,1,1500,0,0,1500,0,0,1458.42980683877,6,1,1500,0,0,1456.42750955872,6,1,1455.16567144668,6,1,1500,0,0
"molteni a",773,1485.77639798388,2,0,1500,0,0,1500,0,0,1485.2060588995,2,0,1500,0,0,1485.18063707233,2,0,1485.6709837753,2,0,1500,0,0
"monaco j",774,1713.21456046193,575,324,1640.91913036892,198,95,1485.27597521129,16,6,1701.51073304298,352,220,1472.40903445168,9,3,1696.00014388305,377,229,1726.9244782261,500,293,1501.97561170022,75,31
"monfils g",775,1872.10352854221,587,374,1825.38671250702,359,232,1592.48456428396,49,29,1775.73266016169,167,106,1527.69402017891,12,7,1760.59362815307,228,142,1838.19424477391,467,291,1761.11561744894,120,83
"montanes a",776,1560.88877603639,540,254,1417.984957372,120,37,1454.41350058954,19,6,1586.09336494605,396,211,1449.14204809213,5,0,1568.46279978455,420,217,1596.52712739975,457,224,1425.85975513653,83,30
"montcourt m",777,1502.73701107132,15,5,1471.24907712872,4,0,1500,0,0,1510.53326534399,11,5,1500,0,0,1512.28371643153,11,5,1482.75501223261,8,2,1506.29222248122,7,3
"monteiro t",778,1536.4003380036,12,6,1474.95065466987,2,0,1500,0,0,1557.81352135945,10,6,1500,0,0,1559.32146180118,10,6,1534.36303064767,12,6,1500,0,0
"moodie w",779,1563.52862525151,110,47,1545.6218207695,77,34,1496.32469679181,21,9,1464.75625872613,5,1,1497.95492884411,7,3,1491.13226107497,33,13,1543.76810441699,95,41,1502.19075890933,15,6
"mor l",780,1487.30934559922,1,0,1487.64918591405,1,0,1500,0,0,1500,0,0,1500,0,0,1500,0,0,1487.23488231109,1,0,1500,0,0
"moraru g",781,1476.82902684867,2,0,1500,0,0,1500,0,0,1478.06251148133,2,0,1500,0,0,1477.30576146554,2,0,1475.87353689506,2,0,1500,0,0
"moretti h",782,1488.63832896601,1,0,1500,0,0,1500,0,0,1488.53488575578,1,0,1500,0,0,1488.53488575578,1,0,1488.09314859492,1,0,1500,0,0
"moriya h",783,1479.77726619432,11,2,1474.89766763252,10,2,1493.6638198636,1,0,1500,0,0,1500,0,0,1494.80202846153,1,0,1496.88928157844,8,2,1474.65857079613,3,0
"morrison j",784,1459.14247054805,85,32,1462.01769849853,65,25,1467.35379109946,16,6,1483.20514527452,4,1,1500,0,0,1454.33871493587,20,7,1484.42676012858,73,29,1442.85870257787,12,3
"moser f",785,1482.02687469456,2,0,1487.5,1,0,1488.7783046609,1,0,1500,0,0,1500,0,0,1493.97915763806,1,0,1480.96404299236,2,0,1500,0,0
"mota b",786,1493.04141504719,3,1,1500,0,0,1500,0,0,1487.25770113251,3,1,1500,0,0,1489.83152715148,3,1,1491.80055634104,3,1,1500,0,0
"motomura g",787,1424.09289176664,20,5,1425.79451514171,17,4,1487.63643602396,3,1,1500,0,0,1500,0,0,1489.90687841981,3,1,1434.81738028355,18,5,1477.28130255229,2,0
"moya c",788,1586.77325479689,560,363,1606.32719110207,250,150,1496.18383260304,12,5,1620.37653824034,287,202,1523.27040127706,11,6,1612.44476095251,310,213,1615.17000466087,475,312,1576.2833014709,85,51
"moyano d",789,1474.32255968926,2,0,1500,0,0,1500,0,0,1474.79987348833,2,0,1500,0,0,1474.68025283855,2,0,1474.79333972583,2,0,1500,0,0
"muller g",790,1774.9457471339,321,159,1709.06069151864,216,110,1612.73372017539,58,30,1481.40718466345,40,17,1460.43839565927,7,2,1637.91803079718,105,49,1771.36081361877,260,132,1551.08300553093,61,27
"munar j",791,1492.15937027012,4,1,1500,0,0,1500,0,0,1486.47729228373,4,1,1500,0,0,1486.01289020375,4,1,1490.19704570999,4,1,1500,0,0
"munoz de la nava d",792,1407.02936585667,37,9,1489.23157955632,10,3,1500,0,0,1397.63781948901,27,6,1500,0,0,1397.17280099443,27,6,1426.10926192367,32,9,1448.0174322293,5,0
"murray a",793,2234.22718258076,759,589,2113.57272717745,501,393,1935.04587847414,106,89,1998.346808412,128,89,1634.64061062885,24,18,2102.45802003392,258,196,2173.44879750639,546,416,2023.25981925304,213,173
"muster t",794,1470.74516782154,3,0,1474.58753922738,2,0,1500,0,0,1492.34727025763,1,0,1500,0,0,1494.5661579381,1,0,1470.87802102911,3,0,1500,0,0
"mutis o",795,1462.42798038282,60,24,1430.41026719808,15,3,1487.44708412932,5,2,1516.14904590654,39,19,1487.09564005016,1,0,1504.59997831865,45,21,1455.45727204753,48,19,1490.03945749993,12,5
"myneni s",796,1492.23792051761,1,0,1487.54482156411,1,0,1500,0,0,1500,0,0,1500,0,0,1500,0,0,1500,0,0,1487.87986865697,1,0
"nadal parera r",797,1497.87346422265,2,1,1500,0,0,1500,0,0,1500.8683590741,2,1,1500,0,0,1500.65099381632,2,1,1497.37475363161,2,1,1500,0,0
"nadal r",798,1993.43536691449,943,773,1900.40938116456,474,361,1736.83955174923,75,58,2106.3697610461,380,347,1526.79292052035,14,7,2057.44774081322,469,412,1988.73946587158,700,562,1989.55165360758,243,211
"nader m",799,1486.59660869203,1,0,1487.15691397939,1,0,1500,0,0,1500,0,0,1500,0,0,1500,0,0,1486.6454481149,1,0,1500,0,0
"nalbandian d",800,1751.03606301274,537,357,1745.7406466431,262,168,1640.34169971101,42,29,1722.88141745565,189,125,1728.39019527116,44,35,1748.71978435032,275,189,1760.33450755679,409,269,1663.04451001496,128,88
"nam h w",801,1471.55841775744,2,0,1472.73819447954,2,0,1500,0,0,1500,0,0,1500,0,0,1500,0,0,1471.98413369427,2,0,1500,0,0
"nargiso d",802,1550.55720747875,11,8,1501.1638107866,2,1,1500,0,0,1556.91895841036,9,7,1500,0,0,1555.9522197125,9,7,1552.41173213968,11,8,1500,0,0
"naso g",803,1437.62006987113,14,3,1500,0,0,1500,0,0,1428.6045739011,14,3,1500,0,0,1427.21528458052,14,3,1437.99654388704,14,3,1500,0,0
"navarra m",804,1488.82668476427,1,0,1500,0,0,1500,0,0,1490.10870128481,1,0,1500,0,0,1489.76197381493,1,0,1489.48377664524,1,0,1500,0,0
"navarro pastor i",805,1466.73718923779,100,35,1421.10001455214,24,5,1472.32455651152,17,6,1477.46278751264,58,24,1491.70335550936,1,0,1478.84974926615,76,30,1470.57973032943,89,33,1455.57066102646,11,2
"navarro s",806,1499.38509003196,5,2,1500,0,0,1500,0,0,1496.72976800906,5,2,1500,0,0,1498.00783146257,5,2,1496.9543015848,5,2,1500,0,0
"nedelko i",807,1478.96669440258,2,0,1474.71962298893,2,0,1500,0,0,1500,0,0,1500,0,0,1500,0,0,1478.69180053759,2,0,1500,0,0
"nedovyesov a",808,1421.88228994489,23,4,1458.22693722128,11,2,1468.09375095356,3,0,1457.18360345108,9,2,1500,0,0,1432.12121832962,12,2,1415.29314643645,15,2,1484.75880471617,8,2
"nedovyesov o",809,1487.53808128189,1,0,1488.26089486621,1,0,1500,0,0,1500,0,0,1500,0,0,1500,0,0,1487.32829722694,1,0,1500,0,0
"nedunchezhiyan j",810,1485.79439571408,1,0,1486.16511191153,1,0,1500,0,0,1500,0,0,1500,0,0,1500,0,0,1486.38184966258,1,0,1500,0,0
"nestor d",811,1440.6801855661,26,8,1447.53570918752,15,4,1478.80212385948,10,4,1500,0,0,1487.5,1,0,1472.94715590276,11,4,1411.16384658069,17,3,1517.09733385903,9,5
"neumuller i",812,1489.33342981441,1,0,1500,0,0,1500,0,0,1487.08592055553,1,0,1500,0,0,1488.91605173094,1,0,1489.50716261558,1,0,1500,0,0
"nielsen f",813,1402.41181839332,10,0,1431.83207869234,6,0,1463.29879797995,3,0,1492.40235667741,1,0,1500,0,0,1457.91664306222,4,0,1404.02597649325,9,0,1487.10588892777,1,0
"nielsen m",814,1439.01816590844,9,1,1435.00539700709,9,1,1500,0,0,1500,0,0,1500,0,0,1500,0,0,1438.07615415528,9,1,1500,0,0
"niemeyer f",815,1466.4011732512,20,4,1443.81790278922,17,3,1489.16908791275,3,1,1500,0,0,1500,0,0,1497.00219658683,3,1,1455.22846005959,18,3,1500.33735301373,2,1
"nieminen j",816,1542.17364693654,692,358,1538.2226365115,424,222,1481.97425261204,55,24,1539.24358301547,183,97,1527.5591685778,30,15,1529.43320830502,268,136,1521.09489497588,584,304,1559.24367434824,108,54
"nijaki r",817,1488.70541914884,1,0,1500,0,0,1500,0,0,1488.8092905224,1,0,1500,0,0,1488.58526769132,1,0,1487.17656988033,1,0,1500,0,0
"niki t",818,1487.59166643899,1,0,1487.52566551438,1,0,1500,0,0,1500,0,0,1500,0,0,1500,0,0,1487.53379440209,1,0,1500,0,0
"nikles j",819,1489.26504409647,1,0,1500,0,0,1500,0,0,1487.43868373652,1,0,1500,0,0,1488.73840198734,1,0,1489.31834815984,1,0,1500,0,0
"niland c",820,1479.64660816886,3,0,1499.29913870861,1,0,1487.72467288199,1,0,1487.34679194792,1,0,1500,0,0,1474.88361804727,2,0,1490.10029032954,1,0,1484.90664186577,2,0
"nishikori k",821,1978.09335431085,412,276,1914.94480404437,288,193,1629.19508143474,41,24,1871.98806595026,83,59,1500,0,0,1892.54592252077,124,83,1944.31643069139,324,216,1814.01295226181,88,60
"nishioka y",822,1515.15000399081,29,11,1509.74106693775,26,11,1475.72593179198,2,0,1496.90286434645,1,0,1500,0,0,1473.04937262469,3,0,1530.39712603124,22,10,1453.72536901401,7,1
"norby r",823,1485.92038330481,1,0,1485.14443921914,1,0,1500,0,0,1500,0,0,1500,0,0,1500,0,0,1487.18618896629,1,0,1500,0,0
"norman d",824,1426.60326178405,54,14,1441.17872023742,16,3,1474.10173534396,19,7,1418.26153372171,16,3,1486.99973631636,3,1,1433.62645354175,38,11,1421.13700126282,40,10,1449.48707739779,14,4
"norman m",825,1502.01658831061,182,107,1553.06729966776,106,65,1500.01671385569,2,1,1496.45882708754,73,41,1487.09831339114,1,0,1486.92777437897,76,42,1516.08771530592,153,88,1545.26010282223,29,19
"novak d",826,1477.28995237211,5,1,1491.01966619341,1,0,1500,0,0,1483.28705554795,4,1,1500,0,0,1482.62294395546,4,1,1479.34203549456,5,1,1500,0,0
"novak j",827,1609.46745952991,358,212,1661.3628273821,175,105,1520.08532609071,27,14,1591.57664801721,124,76,1527.50808950884,32,17,1556.56322575575,183,107,1572.3537106083,291,170,1619.54311576926,67,42
"novikov d",828,1479.70957014105,11,3,1479.11747717538,7,2,1473.99315919875,4,1,1500,0,0,1500,0,0,1481.56553926232,4,1,1468.424258017,7,1,1503.81292251795,4,2
"nunez e",829,1488.33080475923,1,0,1487.45068296401,1,0,1500,0,0,1500,0,0,1500,0,0,1500,0,0,1489.11207052877,1,0,1500,0,0
"o brien a",830,1448.83715329512,11,3,1450.80092695072,8,2,1501.14695515403,2,1,1500,0,0,1487.05047029068,1,0,1489.34094145808,3,1,1465.31426358983,7,2,1475.54415415539,4,1
"o neal j",831,1484.54937753506,1,0,1485.08602759547,1,0,1500,0,0,1500,0,0,1500,0,0,1500,0,0,1485.64052273506,1,0,1500,0,0
"odesnik w",832,1520.37604823925,97,40,1464.25407821263,61,22,1443.17261304828,5,0,1589.36024675916,31,18,1500,0,0,1542.4679514916,36,18,1556.60426619254,76,35,1422.6262885595,21,5
"ogorodov o",833,1477.97123714362,12,4,1474.22315537396,9,3,1500,0,0,1500.1080871655,3,1,1500,0,0,1498.99429908584,3,1,1469.86673575953,10,3,1499.34928640066,2,1
"okun n",834,1419.01638514847,62,20,1426.82881801774,47,16,1441.80561650491,7,1,1502.24397454976,4,2,1481.86314628263,4,1,1437.04951577142,15,4,1422.15936004083,53,18,1452.29017765007,9,2
"olaso g",835,1490.94292086186,6,2,1485.71955345647,1,0,1500,0,0,1497.5318806555,5,2,1500,0,0,1498.23527543185,5,2,1489.41569439938,6,2,1500,0,0
"olejniczak d",836,1470.88866451261,3,0,1500,0,0,1487.87319931459,1,0,1480.94650389183,2,0,1500,0,0,1472.02786950183,3,0,1476.90884457716,2,0,1487.34831083501,1,0
"olguin l",837,1493.07012164319,1,0,1500,0,0,1500,0,0,1492.92691764391,1,0,1500,0,0,1492.15732072949,1,0,1492.2510594183,1,0,1500,0,0
"olivetti a",838,1486.81196942084,14,5,1516.69359263197,11,5,1474.93618647209,2,0,1488.4587164505,1,0,1500,0,0,1464.15899465309,3,0,1517.55857259979,11,5,1461.45208283385,3,0
"olivo r",839,1561.77075115479,23,12,1487.83563458743,3,1,1500,0,0,1558.87301920462,20,11,1500,0,0,1558.13756207215,20,11,1556.87465829881,21,11,1497.84889947922,2,1
"oncins j",840,1486.14221537145,1,0,1487.29141496399,1,0,1500,0,0,1500,0,0,1500,0,0,1500,0,0,1486.67879578169,1,0,1500,0,0
"ondruska m",841,1445.77200983015,8,1,1445.50741162142,5,0,1487.5,1,0,1507.7927620527,2,1,1500,0,0,1494.30569463457,3,1,1438.63195662452,5,0,1488.21777391325,3,1
"onoda m",842,1449.757997464,4,0,1451.35010006477,4,0,1500,0,0,1500,0,0,1500,0,0,1500,0,0,1450.8935314004,4,0,1500,0,0
"opelka r",843,1547.85942337231,10,5,1548.45549452645,9,5,1500,0,0,1489.59366549709,1,0,1500,0,0,1492.77946774769,1,0,1542.00587995919,10,5,1500,0,0
"ortega olmedo r",844,1490.92664343672,1,0,1500,0,0,1500,0,0,1489.58590275838,1,0,1500,0,0,1489.74338243592,1,0,1489.92092540029,1,0,1500,0,0
"ortegren j",845,1500.97314754356,2,1,1502.20597498572,2,1,1500,0,0,1500,0,0,1500,0,0,1500,0,0,1501.07746330445,2,1,1500,0,0
"oswald p",846,1482.00043487073,4,1,1490.72667834262,1,0,1500,0,0,1489.11088836604,3,1,1500,0,0,1489.55882563719,3,1,1481.24220918276,4,1,1500,0,0
"ouahab l",847,1474.83535030068,13,4,1478.17194920882,2,0,1500,0,0,1488.22683737022,11,4,1500,0,0,1488.11963141804,11,4,1481.71770653015,12,4,1488.00023710199,1,0
"ouahabi t",848,1489.66712838443,1,0,1500,0,0,1500,0,0,1488.75342279908,1,0,1500,0,0,1487.7827894886,1,0,1489.63475578085,1,0,1500,0,0
"ouanna j",849,1515.55691596831,26,9,1477.95254728821,11,3,1500,0,0,1484.99647219106,11,4,1507.06893758209,4,2,1510.84870025189,15,6,1488.03038613798,17,5,1512.38791985057,9,4
"oudsema s",850,1481.15879577155,5,1,1490.83451548586,4,1,1489.23657933048,1,0,1500,0,0,1500,0,0,1487.88515699556,1,0,1480.85440634946,5,1,1500,0,0
"ouyang b",851,1491.89663591112,1,0,1486.60374017051,1,0,1500,0,0,1500,0,0,1500,0,0,1500,0,0,1492.13569319036,1,0,1500,0,0
"paes l",852,1432.51669626734,14,4,1441.28249139785,11,3,1501.69471715219,2,1,1487.05047029068,1,0,1500,0,0,1485.80182743675,3,1,1429.1532594273,10,2,1499.07474857783,4,2
"paire b",853,1572.12674369732,258,121,1552.85422901991,134,60,1468.32984086146,24,10,1618.84387584527,100,51,1500,0,0,1584.22348481043,124,61,1565.69425258545,211,98,1556.83722635792,47,23
"palmer j",854,1510.72137891448,4,2,1517.84404858848,3,2,1487.5,1,0,1500,0,0,1500,0,0,1487.83314886987,1,0,1509.64385974477,4,2,1500,0,0
"panfil g",855,1485.90510632571,1,0,1500,0,0,1500,0,0,1486.64334792694,1,0,1500,0,0,1485.99999539654,1,0,1485.40536025353,1,0,1500,0,0
"parada f",856,1484.24013000268,2,0,1500,0,0,1500,0,0,1486.8033692251,2,0,1500,0,0,1485.39024242097,2,0,1485.31390397736,2,0,1500,0,0
"parmar a",857,1458.57930565409,37,13,1466.7930545394,11,3,1456.82768897743,25,10,1500,0,0,1487.17366431058,1,0,1456.25822555564,26,10,1475.8874425088,29,11,1463.04199236228,8,2
"pasha n",858,1488.51696959341,1,0,1488.01561264629,1,0,1500,0,0,1500,0,0,1500,0,0,1500,0,0,1488.7289922161,1,0,1500,0,0
"pashanski b",859,1454.46460222977,72,24,1494.56432264326,16,6,1468.19066109382,3,0,1445.10664736281,51,17,1499.73729867714,2,1,1431.0298382981,56,18,1480.58985030292,63,23,1431.98637378043,9,1
"patience o",860,1412.81331813785,79,26,1416.48400873851,18,4,1497.77891651896,6,3,1436.74424676645,54,19,1487.01405543238,1,0,1429.41538175267,61,22,1418.79030102293,59,20,1432.51064999232,20,6
"patino l",861,1490.57958708259,1,0,1487.3585969868,1,0,1500,0,0,1500,0,0,1500,0,0,1500,0,0,1490.29631407653,1,0,1500,0,0
"patriarca d",862,1487.5,1,0,1500,0,0,1500,0,0,1487.5,1,0,1500,0,0,1487.5,1,0,1487.5,1,0,1500,0,0
"paul t",863,1467.03647308669,6,1,1460.11721966629,4,0,1500,0,0,1501.5403965752,2,1,1500,0,0,1500.53459547361,2,1,1470.61604623837,5,1,1491.90434471793,1,0
"pavel a",864,1477.46938150003,361,182,1449.01838627111,166,81,1472.48587983867,35,16,1555.99243119211,130,71,1493.71408596624,30,14,1509.00271430749,195,101,1505.6489920856,301,153,1489.65914195899,60,29
"pavic a",865,1467.23346987609,13,3,1474.51337516605,5,1,1489.05231277045,6,2,1482.74582574521,2,0,1500,0,0,1473.23742195926,8,2,1460.73212158101,10,2,1499.16528147577,3,1
"pavic m",866,1473.07553700902,11,3,1488.44138474791,1,0,1487.77192098647,5,2,1482.83039536777,5,1,1500,0,0,1471.88593008741,10,3,1471.75571685755,11,3,1500,0,0
"pavlasek a",867,1507.78368842629,6,3,1491.29511174853,1,0,1500,0,0,1515.90672830482,5,3,1500,0,0,1516.53760408847,5,3,1500.74641644013,4,2,1505.30871537719,2,1
"pedroso a",868,1492.70596669682,1,0,1492.59664682382,1,0,1500,0,0,1500,0,0,1500,0,0,1500,0,0,1493.28030748533,1,0,1500,0,0
"peliwo f",869,1490.32364867829,6,2,1490.06785631739,4,1,1500,0,0,1505.24622813168,2,1,1500,0,0,1504.82533128694,2,1,1490.43465743116,6,2,1500,0,0
"pella g",870,1534.45421063499,68,25,1494.0911223546,26,8,1462.47783896914,4,0,1538.32573498074,38,17,1500,0,0,1516.44308503295,42,17,1519.53614717797,54,21,1486.98579368539,14,4
"peppas s",871,1490.51645790522,1,0,1500,0,0,1500,0,0,1491.86003385844,1,0,1500,0,0,1490.99932322666,1,0,1490.27335453048,1,0,1500,0,0
"peralta j",872,1487.43578038567,1,0,1500,0,0,1500,0,0,1488.96720627435,1,0,1500,0,0,1488.19981421109,1,0,1487.12486743061,1,0,1500,0,0
"perez d",873,1447.53986083006,7,1,1500,0,0,1500,0,0,1443.57848855819,7,1,1500,0,0,1444.96158980133,7,1,1458.06631064503,6,1,1487.09378297823,1,0
"peric t",874,1489.48814707945,1,0,1500,0,0,1500,0,0,1489.99471879552,1,0,1500,0,0,1488.73723244873,1,0,1489.16258143435,1,0,1500,0,0
"perry t",875,1488.19835022987,1,0,1487.61516662242,1,0,1500,0,0,1500,0,0,1500,0,0,1500,0,0,1500,0,0,1488.09148997889,1,0
"pescariu d",876,1490.5527706032,3,1,1500,0,0,1500,0,0,1491.9735992812,3,1,1500,0,0,1491.25117717237,3,1,1491.48502672416,3,1,1500,0,0
"peschek d",877,1488.36492282123,1,0,1500,0,0,1500,0,0,1487.21912092491,1,0,1500,0,0,1488.71469240311,1,0,1488.28614387785,1,0,1500,0,0
"pescosolido s",878,1464.0299529439,7,1,1493.7501817614,1,0,1490.26689943216,3,1,1470.40180829918,3,0,1500,0,0,1463.13401159278,6,1,1456.36121349862,5,0,1499.77282303884,2,1
"petrovic d",879,1456.33625165601,8,2,1473.69739977226,4,1,1476.69705692732,4,1,1500,0,0,1500,0,0,1479.59392007398,4,1,1492.13295983411,5,2,1462.23357955609,3,0
"petzschner p",880,1555.5642278789,188,86,1535.11884547026,110,51,1567.06675454628,37,19,1490.11553806084,39,16,1474.75403229987,2,0,1560.16916812632,78,35,1588.34268296257,153,71,1490.19501579604,35,15
"peya a",881,1403.34798198702,63,18,1454.14274005346,21,6,1418.85475980907,15,3,1431.46178001671,22,6,1519.28387246734,5,3,1397.28601864197,42,12,1418.93050421903,52,15,1456.61633139192,11,3
"pfeiffer k",882,1491.01145136183,1,0,1500,0,0,1500,0,0,1490.38448086801,1,0,1500,0,0,1490.63913256555,1,0,1490.66105253236,1,0,1500,0,0
"phau b",883,1522.62087955676,211,77,1495.05425681591,137,55,1395.92584542309,14,1,1485.60985858239,57,21,1464.45705469293,3,0,1450.4642408456,74,22,1526.1804519902,179,70,1401.55969552311,32,7
"philippoussis m",884,1626.58397928715,220,126,1503.47009845755,138,78,1663.88885967498,45,32,1497.85094456619,26,10,1517.56284056538,11,6,1677.90962570924,82,48,1613.51480130558,163,91,1589.12815352943,57,35
"phillips t",885,1491.78341725592,1,0,1490.82477895081,1,0,1500,0,0,1500,0,0,1500,0,0,1500,0,0,1490.71974377889,1,0,1500,0,0
"piccari f",886,1484.94234173672,1,0,1500,0,0,1500,0,0,1485.64362879864,1,0,1500,0,0,1486.20545857483,1,0,1485.30082118929,1,0,1500,0,0
"pioline c",887,1508.09517882332,116,59,1522.57474457801,54,28,1496.05318680763,15,7,1543.60600484602,41,24,1435.92902189165,6,0,1487.42654484466,62,31,1518.52778698976,95,48,1501.08328272921,21,11
"pless k",888,1406.19035229516,121,42,1421.52205622052,71,26,1424.39497978902,16,4,1438.2297294345,25,8,1499.12418911274,9,4,1406.63062273362,50,16,1403.34711824199,94,33,1441.68765939481,27,9
"podlipnik h",889,1485.1159754658,2,0,1500,0,0,1500,0,0,1485.56116736603,2,0,1500,0,0,1484.28380251405,2,0,1484.39867333046,2,0,1500,0,0
"poerschke l",890,1485.01227234944,2,0,1483.83841997336,2,0,1500,0,0,1500,0,0,1500,0,0,1500,0,0,1483.4732110865,2,0,1500,0,0
"polansky p",891,1457.19190030364,27,6,1471.31039819086,19,5,1487.58847922785,1,0,1461.13393727008,7,1,1500,0,0,1450.01354468948,8,1,1457.44175246558,21,5,1469.75862719238,6,1
"popp a",892,1461.86601698817,108,44,1427.98650355595,41,15,1573.19996400154,38,24,1362.96239091994,27,5,1476.21298808023,2,0,1475.69096108104,67,29,1441.94505905991,75,28,1494.7599542183,33,16
"popp t",893,1479.69226903334,2,0,1500,0,0,1500,0,0,1478.73494919145,2,0,1500,0,0,1478.60360792509,2,0,1480.41449884587,2,0,1500,0,0
"portas a",894,1455.78768216221,220,89,1382.27547410119,32,7,1436.49403513862,12,3,1472.08359292378,171,78,1464.89420835247,5,1,1454.30799247345,188,82,1470.40739135742,188,77,1427.49988837744,32,12
"pospisil j",895,1461.62088342215,8,1,1495.9208442778,3,1,1479.76606160485,2,0,1467.65290425606,3,0,1500,0,0,1452.68984521727,5,0,1467.9464296596,7,1,1489.28127473108,1,0
"pospisil v",896,1598.69884851913,173,76,1620.26555577848,128,61,1483.64794897624,27,11,1412.76308447832,18,4,1500,0,0,1452.10579850813,45,15,1594.0207204578,145,65,1489.33862554553,28,11
"pouille l",897,1786.96994714105,90,47,1678.63307209644,53,27,1513.37320642284,9,4,1627.81484790381,28,16,1500,0,0,1650.27590735616,37,20,1724.91292732354,69,37,1568.95788029226,21,10
"pozzi g",898,1398.64395043955,78,33,1441.12713465783,42,17,1512.00488200013,19,11,1436.52425876709,10,2,1488.95987475067,7,3,1443.04355427419,36,16,1417.73338647778,64,27,1475.49906526423,14,6
"prashanth v",899,1488.29967926045,1,0,1486.33676852319,1,0,1500,0,0,1500,0,0,1500,0,0,1500,0,0,1487.8099828437,1,0,1500,0,0
"pretzsch a",900,1443.24001175335,21,6,1460.77848190483,17,6,1470.42585525583,3,0,1486.42351207674,1,0,1500,0,0,1456.58587755732,4,0,1445.46267184501,18,5,1488.81777356997,3,1
"prieto s",901,1450.73314911655,6,1,1500,0,0,1500,0,0,1458.81194986587,6,1,1500,0,0,1455.47686490973,6,1,1451.26365495936,6,1,1500,0,0
"prinosil d",902,1433.84895488221,77,31,1409.29109786144,38,11,1531.77888293976,21,13,1422.39852801877,7,0,1530.17987304497,11,7,1503.94887808433,39,20,1430.2423972463,62,24,1494.55395536532,15,7
"prodon e",903,1361.72023534126,20,1,1467.61917795326,3,0,1500,0,0,1373.53766972373,17,1,1500,0,0,1377.9418453276,17,1,1397.38429498237,13,1,1440.92027398695,7,0
"prpic a",904,1473.57798498338,2,0,1500,0,0,1500,0,0,1473.71822416261,2,0,1500,0,0,1472.59761359998,2,0,1474.48907736325,2,0,1500,0,0
"prpic f",905,1454.58131075572,10,2,1489.40646401066,5,2,1500,0,0,1446.53409730968,5,0,1500,0,0,1447.48250898318,5,0,1453.55858707638,10,2,1500,0,0
"przysiezny m",906,1413.07460238423,78,19,1434.98380370515,42,11,1464.50023480103,12,4,1391.1924846951,24,4,1500,0,0,1378.26324781832,36,8,1409.05389284138,63,15,1447.17888583781,15,4
"puentes g",907,1425.62741440868,22,6,1473.50585179913,5,1,1498.86993451853,2,1,1439.67818860236,15,4,1500,0,0,1437.83226675665,17,5,1430.96190685306,18,5,1481.66927032972,4,1
"puerta m",908,1587.33078550331,161,84,1473.779212103,29,10,1461.75359245119,3,0,1649.23944177902,124,73,1464.00111464073,5,1,1589.26834503093,132,74,1560.97588791328,137,72,1515.81274532051,24,12
"puetz t",909,1500.35585808918,3,1,1488.66824894801,1,0,1499.51130031386,2,1,1500,0,0,1500,0,0,1508.64221694052,2,1,1500,0,0,1488.25499110557,3,1
"querrey s",910,1661.07518835779,488,271,1608.36448844653,329,187,1657.51954986917,78,49,1552.14232192385,76,34,1477.46224319472,5,1,1673.13233843408,159,84,1646.11896768056,410,232,1559.98332256709,78,39
"querry s",911,1473.08754961469,7,2,1468.59610877214,5,1,1501.32891190289,2,1,1500,0,0,1500,0,0,1500.96687288082,2,1,1471.94377077119,7,2,1500,0,0
"quigley e",912,1489.85125095505,1,0,1488.47423494194,1,0,1500,0,0,1500,0,0,1500,0,0,1500,0,0,1488.10737545397,1,0,1500,0,0
"quintero m",913,1486.58760766386,1,0,1500,0,0,1500,0,0,1487.23731129135,1,0,1500,0,0,1487.16248105618,1,0,1487.13243921997,1,0,1500,0,0
"qureshi a",914,1506.26833404281,10,4,1487.86618166241,1,0,1504.78587687836,9,4,1500,0,0,1500,0,0,1511.51486759617,9,4,1499.75795960963,8,3,1506.49987071216,2,1
"qureshi a u h",915,1483.22506455644,5,1,1474.86575208809,3,0,1501.5111376092,2,1,1500,0,0,1500,0,0,1499.80679524119,2,1,1488.57855826755,4,1,1491.4223334531,1,0
"rachidi y",916,1486.92438305802,1,0,1500,0,0,1500,0,0,1487.16280363859,1,0,1500,0,0,1487.14898969201,1,0,1486.83647841432,1,0,1500,0,0
"radic m",917,1483.70705710668,6,2,1500,0,0,1500,0,0,1478.96283730072,6,2,1500,0,0,1479.2278738455,6,2,1483.43797809151,6,2,1500,0,0
"rafter p",918,1780.12360278692,103,72,1721.3505808602,65,45,1648.24147193818,26,21,1466.16882236783,5,1,1535.03949547424,7,5,1648.05702716411,38,27,1740.22202467966,75,51,1644.39621148908,28,21
"raja p",919,1487.32785251123,1,0,1486.39387359661,1,0,1500,0,0,1500,0,0,1500,0,0,1500,0,0,1487.70793349497,1,0,1500,0,0
"ram a",920,1428.70413932568,10,1,1432.98680682067,8,1,1488.3071152272,1,0,1500,0,0,1488.70654316842,1,0,1484.34356417038,2,0,1442.93019375135,8,1,1477.90754986465,2,0
"ram r",921,1504.7788281693,145,54,1460.15746946335,101,33,1539.18271717955,34,18,1464.48382241351,10,3,1500,0,0,1509.29263032295,44,21,1508.61092087302,124,49,1430.90964745376,21,5
"ramanathan r",922,1491.57572667035,8,3,1484.96646209656,8,3,1500,0,0,1500,0,0,1500,0,0,1500,0,0,1490.51160093946,8,3,1500,0,0
"ramirez c",923,1476.17994162844,3,0,1500,0,0,1500,0,0,1479.29482448758,3,0,1500,0,0,1477.90988530192,3,0,1475.10780019465,3,0,1500,0,0
"ramirez hidalgo r",924,1367.85763546269,201,68,1400.77300702905,36,7,1419.08173498062,8,0,1390.63052947519,155,61,1477.46327200007,2,0,1362.78276070516,165,61,1370.46012047993,176,63,1387.41474676101,25,5
"ramos a",925,1597.65537345086,147,67,1470.08161782335,48,16,1483.61989066047,5,1,1602.59692886807,94,50,1500,0,0,1603.95274458974,99,51,1609.93509738779,133,65,1436.01951637238,14,2
"ramos vinolas a",926,1685.54878006154,120,55,1581.41930770111,47,20,1509.68540530024,7,3,1649.3923704118,66,32,1500,0,0,1656.90116200622,73,35,1636.60079177349,102,46,1565.23242849822,18,9
"raonic m",927,1967.0817721182,358,244,1893.14784261,244,171,1689.8036249336,41,27,1761.94936181526,73,46,1500,0,0,1857.89624634209,114,73,1926.14733958019,277,186,1795.56389673856,81,58
"raoux g",928,1476.13666343609,2,0,1486.60210182637,1,0,1500,0,0,1490.19875398687,1,0,1500,0,0,1490.19875398687,1,0,1487.05047029068,1,0,1487.94952970932,1,0
"rascon t",929,1490.85424183861,1,0,1490.12904955901,1,0,1500,0,0,1500,0,0,1500,0,0,1500,0,0,1489.84776909917,1,0,1500,0,0
"rastogi k",930,1474.9223693752,5,1,1474.17146143994,5,1,1500,0,0,1500,0,0,1500,0,0,1500,0,0,1473.5418105652,5,1,1500,0,0
"ratiwatana s",931,1487.09957671059,1,0,1487.68521520089,1,0,1500,0,0,1500,0,0,1500,0,0,1500,0,0,1487.11994460475,1,0,1500,0,0
"rea s",932,1477.05547726807,2,0,1475.77747272734,2,0,1500,0,0,1500,0,0,1500,0,0,1500,0,0,1475.60250624445,2,0,1500,0,0
"recouderc l",933,1442.08568741345,15,3,1440.94256115205,8,1,1500,0,0,1483.10389058772,7,2,1500,0,0,1487.66632685993,7,2,1448.90535401245,10,2,1476.07848523935,5,1
"rehnquist b",934,1459.95820378608,13,3,1439.04011606161,7,0,1500,0,0,1507.70307521903,6,3,1500,0,0,1507.48602789843,6,3,1474.60728670286,10,3,1473.46037441761,3,0
"reichel a",935,1493.06906598756,1,0,1493.33072852723,1,0,1500,0,0,1500,0,0,1500,0,0,1500,0,0,1493.31527548244,1,0,1500,0,0
"reid m",936,1494.16334682574,1,0,1500,0,0,1492.2270129035,1,0,1500,0,0,1500,0,0,1492.28675123925,1,0,1500,0,0,1490.33291810124,1,0
"reid t",937,1512.73964275561,35,14,1499.8105958422,26,11,1484.41054061916,8,3,1487.01679212304,1,0,1500,0,0,1470.02617922905,9,3,1524.01247667223,27,12,1464.37526940864,8,2
"reister j",938,1430.22128848903,48,14,1449.03538594277,5,0,1476.75436119012,9,3,1450.19492203629,32,11,1474.52395899858,2,0,1438.57943524121,43,14,1422.63516290136,34,9,1475.00002151952,14,5
"reix c",939,1510.30591473604,2,1,1508.35109413047,2,1,1500,0,0,1500,0,0,1500,0,0,1500,0,0,1509.98646951146,2,1,1500,0,0
"renavand n",940,1509.05949957303,2,1,1505.19470046293,2,1,1500,0,0,1500,0,0,1500,0,0,1500,0,0,1507.4570975529,2,1,1500,0,0
"reneberg r",941,1501.07533270558,2,1,1501.07533270558,2,1,1500,0,0,1500,0,0,1500,0,0,1500,0,0,1501.32739812423,2,1,1500,0,0
"rettenmaier t",942,1507.19054337504,4,2,1501.74634864441,2,1,1501.9063754018,2,1,1500,0,0,1500,0,0,1500.49814576085,2,1,1506.67201972581,4,2,1500,0,0
"reyes varela m a",943,1480.79164404064,2,0,1491.31789121966,1,0,1500,0,0,1490.18180550084,1,0,1500,0,0,1490.02451436611,1,0,1478.78633876072,2,0,1500,0,0
"reynolds b",944,1440.37001015203,100,28,1402.44187592057,74,20,1446.84712790382,17,5,1493.46754711969,8,3,1493.8440450608,1,0,1464.30662764845,26,8,1430.20895001688,76,21,1448.97057149393,24,7
"riba p",945,1393.21336613215,86,24,1395.99828334598,20,3,1439.15457749306,5,0,1440.32691536385,61,21,1500,0,0,1418.46460979297,66,21,1407.45605680763,70,20,1429.34241233148,16,4
"rieschick s",946,1475.3223134618,4,1,1499.63746446225,2,1,1500,0,0,1472.81939224564,2,0,1500,0,0,1472.01714004389,2,0,1474.50610474562,4,1,1500,0,0
"rios f",947,1487.00631435746,1,0,1500,0,0,1500,0,0,1488.0634831393,1,0,1500,0,0,1487.99014330015,1,0,1487.26830853713,1,0,1500,0,0
"rios m",948,1709.66490267623,161,100,1728.20010262879,102,68,1500,0,0,1601.54938841649,56,32,1462.93621530287,3,0,1568.75206224109,59,32,1724.55979371265,141,89,1526.06844274997,20,11
"robert s",949,1539.00509530395,97,36,1494.72870137495,50,20,1472.4374086005,9,3,1503.73872692631,38,13,1500,0,0,1506.89512231997,47,16,1524.61498782021,68,26,1476.67227435515,29,10
"robredo r",950,1518.17193417142,3,1,1513.63267479379,3,1,1500,0,0,1500,0,0,1500,0,0,1500,0,0,1516.35289932475,3,1,1500,0,0
"robredo t",951,1670.00458755358,842,514,1655.00810784819,390,219,1542.89947863296,54,30,1671.43681921885,364,249,1511.11379192581,34,16,1656.74769615574,452,295,1669.1201560836,676,406,1683.84237553988,166,108
"rocha d",952,1498.77740730162,3,1,1500,0,0,1500,0,0,1497.79869045204,3,1,1500,0,0,1495.59245355012,3,1,1498.74043939554,3,1,1500,0,0
"rochus c",953,1383.87366407945,321,113,1389.17216892587,129,41,1342.72903777623,25,3,1451.25189620832,150,64,1441.7240668017,17,5,1401.17095363908,192,72,1391.76986488265,272,98,1377.51975887689,49,15
"rochus o",954,1527.1532037911,473,220,1553.00176332389,231,109,1545.17814483495,80,43,1425.71911488054,138,56,1508.09767466356,24,12,1493.95494808921,242,111,1551.7589966458,390,185,1435.27719490096,83,35
"roddick a",955,1830.36941502671,769,574,1794.79208212514,536,402,1781.67128440206,102,81,1625.65744166354,95,66,1617.71596114916,36,25,1777.70954589197,233,172,1821.07272239262,592,442,1761.04493686357,177,132
"rodrigues m",956,1511.64755079339,2,1,1510.82134979743,2,1,1500,0,0,1500,0,0,1500,0,0,1500,0,0,1510.03065475218,2,1,1500,0,0
"rodriguez b",957,1486.8137871897,1,0,1500,0,0,1500,0,0,1487.28580668061,1,0,1500,0,0,1486.94748863488,1,0,1487.5103595116,1,0,1500,0,0
"rodriguez m",958,1444.52543283319,15,5,1474.99803105724,4,1,1500,0,0,1465.87309147008,11,4,1500,0,0,1462.68404733342,11,4,1463.20945406344,13,5,1475.44952970932,2,0
"roger vasselin e",959,1556.50665733111,208,84,1559.83848282208,118,48,1502.05142542874,35,16,1468.25223598528,54,20,1487.15059730814,1,0,1497.10624519908,90,36,1530.48762689301,168,69,1486.04325288751,40,15
"roitman s",960,1394.14187888657,87,25,1399.29979143618,17,2,1460.13756352139,6,1,1448.2992157599,62,22,1474.1583415645,2,0,1421.63229479248,70,23,1421.56686356635,75,25,1409.07524297239,12,0
"rola b",961,1492.43604971794,25,9,1478.52838371589,9,3,1464.89724235516,5,1,1512.10579674922,11,5,1500,0,0,1491.42834559434,16,6,1502.77419306302,18,7,1476.92320805586,7,2
"romboli f",962,1484.66030701142,1,0,1500,0,0,1500,0,0,1486.99140408652,1,0,1500,0,0,1486.16292258596,1,0,1485.6890503607,1,0,1500,0,0
"rosenholm p",963,1508.33063918808,3,1,1505.20742184586,3,1,1500,0,0,1500,0,0,1500,0,0,1500,0,0,1506.6391863324,3,1,1500,0,0
"roshardt r",964,1476.8552111116,2,0,1500,0,0,1500,0,0,1477.91958460075,2,0,1500,0,0,1476.4864152074,2,0,1476.12934275163,2,0,1500,0,0
"rosol l",965,1572.10371852045,242,104,1551.27733908446,137,53,1473.93574421843,18,7,1569.74900919252,87,44,1500,0,0,1549.09888571108,105,51,1557.98166787919,205,89,1502.33739748222,37,15
"rosset m",966,1487.33055755155,137,61,1489.19892919626,54,26,1483.97609543228,18,8,1455.62345898071,39,14,1487.33151233832,26,13,1470.14734059222,83,35,1499.06648367517,116,53,1450.05837941471,21,8
"roux l",967,1481.46570147867,13,5,1476.8011863168,13,5,1500,0,0,1500,0,0,1500,0,0,1500,0,0,1479.23419006434,13,5,1500,0,0
"rubin n",968,1467.97383612593,9,2,1465.70077601337,8,2,1486.58109092,1,0,1500,0,0,1500,0,0,1486.0431189296,1,0,1461.97526928437,6,1,1489.44328164196,3,1
"rublev a",969,1489.18220431819,25,8,1494.57481669142,15,5,1500,0,0,1471.82941737673,10,3,1500,0,0,1474.25535131492,10,3,1481.7470927007,24,8,1494.19677747428,1,0
"ruevski p",970,1487.25294495241,1,0,1500,0,0,1500,0,0,1487.14777579169,1,0,1500,0,0,1487.10876818416,1,0,1487.2453893967,1,0,1500,0,0
"rufin g",971,1530.39740508143,43,16,1523.56595578811,20,9,1480.19354143834,6,2,1480.81327709949,17,5,1500,0,0,1484.59172162868,23,7,1497.52895403646,25,9,1493.16605810987,18,7
"rusedski g",972,1583.4123173625,274,157,1584.48012242062,161,91,1650.56129090377,58,41,1427.64226551997,26,6,1577.91327223387,29,19,1605.13210201264,113,66,1614.91408061149,229,136,1473.63259453485,45,21
"russell m",973,1503.72289309852,224,77,1525.7026382304,143,55,1431.36797166844,33,10,1385.97071440103,47,12,1487.97812334846,1,0,1394.26480524987,81,22,1552.12906287218,184,70,1358.64484028013,40,7
"ruud c",974,1453.26808848056,31,11,1467.86620923112,6,1,1475.46338095484,2,0,1484.26511449524,22,10,1487.5,1,0,1462.12126907135,25,10,1483.50780756362,27,11,1453.17927000896,4,0
"ryderstedt m",975,1486.33083133924,20,8,1501.1174262888,12,5,1500,0,0,1486.56695833932,8,3,1500,0,0,1482.91433349959,8,3,1484.25804685605,20,8,1500,0,0
"sa a",976,1399.41536871262,122,44,1431.9058118314,58,25,1475.25196387924,22,9,1378.52155051512,35,7,1493.13477389845,7,3,1405.68755145607,64,19,1394.61410157742,100,36,1467.33291670248,22,8
"saavedra corvalan c",977,1486.81675859649,1,0,1500,0,0,1500,0,0,1486.76877265066,1,0,1500,0,0,1485.45867566289,1,0,1486.90663717557,1,0,1500,0,0
"sabau r",978,1394.58269511904,44,13,1456.71743993571,7,1,1463.4530998289,5,1,1431.61258744624,30,11,1474.00851451785,2,0,1404.76168234735,37,12,1411.97070676443,40,13,1462.29846099009,4,0
"sabry s",979,1487.75406474701,1,0,1487.49859976092,1,0,1500,0,0,1500,0,0,1500,0,0,1500,0,0,1487.38457952069,1,0,1500,0,0
"sadecky a",980,1493.5054983417,3,1,1500,0,0,1500,0,0,1488.88129681931,3,1,1500,0,0,1489.54667132592,3,1,1493.32306071717,3,1,1500,0,0
"safin m",981,1654.22654833786,540,341,1628.19115491315,295,183,1626.89521689985,42,26,1587.48186567252,141,88,1630.21867664552,62,44,1615.67696517763,245,158,1638.01066778931,417,253,1692.13172620482,123,88
"safwat m",982,1491.76944099625,3,1,1490.4344635491,3,1,1500,0,0,1500,0,0,1500,0,0,1500,0,0,1491.28991825045,3,1,1500,0,0
"salamanca c",983,1489.84340152723,1,0,1500,0,0,1500,0,0,1488.87445972674,1,0,1500,0,0,1488.88309881382,1,0,1490.00191606969,1,0,1500,0,0
"salva b",984,1444.37987588015,5,0,1474.28020085693,2,0,1500,0,0,1468.20516622144,3,0,1500,0,0,1465.89828482643,3,0,1444.6144717436,5,0,1500,0,0
"salzenstein j",985,1423.16095813418,37,11,1426.03867644733,26,7,1483.11658381088,7,3,1486.39431170162,4,1,1500,0,0,1465.59349783735,11,4,1443.13187547574,33,11,1452.15063401876,4,0
"samper montana j",986,1487.5,1,0,1500,0,0,1500,0,0,1487.5,1,0,1500,0,0,1487.5,1,0,1500,0,0,1487.5,1,0
"sampras p",987,1758.20963176989,137,98,1777.5313791612,98,73,1621.47046583404,24,19,1477.10734841255,15,6,1500,0,0,1569.90257442946,39,25,1653.96374643929,83,55,1733.80350648382,54,43
"sanchez d",988,1495.3776083634,200,85,1376.51156048592,44,9,1451.12200324835,4,0,1542.86096999098,149,76,1466.30939952574,3,0,1519.63417924151,156,76,1485.51795121652,173,77,1445.14501326764,27,8
"sanchez de luna j",989,1480.34527189082,3,0,1500,0,0,1500,0,0,1475.36113288011,3,0,1500,0,0,1473.64415343281,3,0,1479.68180315766,3,0,1500,0,0
"sanchez j",990,1487.5,1,0,1487.5,1,0,1500,0,0,1500,0,0,1500,0,0,1500,0,0,1487.5,1,0,1500,0,0
"sanchez m",991,1485.67963873254,1,0,1500,0,0,1500,0,0,1486.05286712256,1,0,1500,0,0,1486.15114670187,1,0,1485.850613399,1,0,1500,0,0
"sandbichler a",992,1487.87270876522,1,0,1500,0,0,1500,0,0,1487.70564883359,1,0,1500,0,0,1488.03022113175,1,0,1487.82454038332,1,0,1500,0,0
"sanguinetti d",993,1463.55490350974,281,114,1503.54995203329,154,70,1453.76053813068,40,16,1433.95577941389,62,19,1437.68298520601,25,9,1416.73499228161,127,44,1453.082575417,241,102,1437.32459976881,40,12
"santillan a",994,1473.02561389669,2,0,1486.65140755121,1,0,1500,0,0,1484.88349749891,1,0,1500,0,0,1484.1146170848,1,0,1473.60475070931,2,0,1500,0,0
"santopadre v",995,1481.33838677098,4,1,1500,0,0,1500,0,0,1491.73120008826,3,1,1487.63483077351,1,0,1479.66348093042,4,1,1479.84702795735,4,1,1500,0,0
"santoro f",996,1591.78505570933,433,222,1551.30946165083,252,133,1621.19151142857,67,41,1413.10679647855,66,25,1519.01264666058,48,23,1592.04078566372,181,89,1590.2253666527,354,184,1538.82241011324,79,38
"saoudi s",997,1492.00451915447,5,2,1486.30200234685,1,0,1500,0,0,1500.13322621604,4,2,1500,0,0,1500.57389290118,4,2,1504.33137530608,4,2,1486.11748866729,1,0
"saretta f",998,1504.91211219513,142,67,1484.75329548093,40,17,1500.44128528897,12,6,1540.83568151651,89,44,1489.67308881876,1,0,1517.5466463689,102,50,1517.87449697205,113,55,1470.78356028504,29,12
"sargsian s",999,1502.41375611395,218,92,1495.00233340275,106,44,1437.30269774298,30,11,1494.96248710652,64,27,1527.84678084478,18,10,1492.31780403136,112,48,1486.86887743862,174,70,1524.49101848204,44,22
"sarkissian a",1000,1499.03338813384,5,2,1494.60924616135,3,1,1500,0,0,1498.42781293043,2,1,1500,0,0,1498.38574802041,2,1,1498.00352877745,5,2,1500,0,0
"sarstrand m",1001,1482.99649675948,2,0,1488.23340498301,1,0,1500,0,0,1494.44958078224,1,0,1500,0,0,1493.87490454707,1,0,1482.02684251503,2,0,1500,0,0
"satral j",1002,1503.2116551554,3,1,1508.87405141127,2,1,1500,0,0,1494.82318532094,1,0,1500,0,0,1494.28425441174,1,0,1493.58495461901,1,0,1507.03611130611,2,1
"saulnier c",1003,1513.72732931112,182,73,1509.23975916741,116,48,1456.19216318702,24,9,1430.25019426159,20,4,1529.0813377308,22,12,1479.29314754053,66,25,1512.51781044027,156,67,1411.38098354607,26,6
"saville l",1004,1475.65686309519,8,2,1475.88271932936,2,0,1485.9960091792,6,2,1500,0,0,1500,0,0,1493.01714323769,6,2,1502.05927915381,2,1,1460.47035572137,6,1
"savolt a",1005,1442.03118787816,73,28,1416.86229981974,23,6,1473.23621322603,2,0,1488.95545431109,47,22,1487.43550226181,1,0,1469.85321372329,50,22,1434.53319888572,60,23,1475.14609068221,13,5
"schalken s",1006,1566.75035981385,299,168,1549.1285398573,170,92,1654.65275759079,48,34,1548.52045117103,60,31,1518.16586345459,21,11,1604.4208831416,129,76,1534.50636140736,241,129,1669.9125629554,58,39
"scherrer j",1007,1498.18190171876,1,0,1500,0,0,1500,0,0,1500,0,0,1488.54268241072,1,0,1495.16679720096,1,0,1497.43794156698,1,0,1500,0,0
"scherrer j c",1008,1468.17301606841,5,1,1487.33371360436,3,1,1474.3016196171,2,0,1500,0,0,1500,0,0,1477.38804688751,2,0,1466.38327837,5,1,1500,0,0
"schiessling t",1009,1484.41680277798,4,1,1500,0,0,1500,0,0,1486.90383311044,4,1,1500,0,0,1484.77586174479,4,1,1484.63295805705,4,1,1500,0,0
"schnur b",1010,1492.34394246247,1,0,1491.45071177701,1,0,1500,0,0,1500,0,0,1500,0,0,1500,0,0,1491.46625464794,1,0,1500,0,0
"scholtz n",1011,1485.34451446967,1,0,1485.0199815807,1,0,1500,0,0,1500,0,0,1500,0,0,1500,0,0,1485.93109630938,1,0,1500,0,0
"schoorel t",1012,1486.51401307727,6,1,1471.23309179052,4,0,1500,0,0,1508.57775323386,2,1,1500,0,0,1508.03840655081,2,1,1474.08230706846,4,0,1506.12914354777,2,1
"schranz w",1013,1495.50460458306,2,1,1500,0,0,1500,0,0,1497.55857313612,2,1,1500,0,0,1497.25718962506,2,1,1496.25059058673,2,1,1500,0,0
"schuettler p",1014,1513.89904780928,3,2,1500,0,0,1500,0,0,1514.49033331972,3,2,1500,0,0,1514.78539091774,3,2,1512.8392194464,3,2,1500,0,0
"schuettler r",1015,1500.3178246817,544,269,1464.63914866832,314,162,1573.79905914393,71,40,1388.9250393542,129,52,1513.04545658806,30,15,1508.28922465117,230,107,1490.00845596629,455,226,1465.02298621465,89,43
"schukin y",1016,1498.82530284868,32,12,1432.2456011644,6,0,1500,0,0,1546.02725644029,25,12,1487.16501456074,1,0,1537.86713787107,26,12,1498.10430117776,29,11,1487.57324578854,3,1
"schuttler p",1017,1485.92819834768,1,0,1500,0,0,1500,0,0,1500,0,0,1487.86571906594,1,0,1486.78337836634,1,0,1485.96754989156,1,0,1500,0,0
"schwank e",1018,1512.76572046045,98,37,1458.42937128038,27,8,1442.16884499923,8,1,1537.20924781146,62,28,1488.81539616814,1,0,1513.79267918207,71,29,1473.38524414898,81,31,1493.66688121272,17,6
"schwartzman d",1019,1629.58737699231,77,31,1573.92617172583,28,13,1452.51157615313,4,0,1552.28579035983,45,18,1500,0,0,1522.79215105459,49,18,1637.62699025382,64,28,1467.21053612379,13,3
"sekulic m",1020,1486.53882006297,1,0,1486.66390537091,1,0,1500,0,0,1500,0,0,1500,0,0,1500,0,0,1486.96005878111,1,0,1500,0,0
"sekulov j",1021,1435.20238485885,12,3,1456.2878039448,10,3,1486.63476371345,1,0,1486.64811173437,1,0,1500,0,0,1472.93143534685,2,0,1433.18390552577,10,2,1500,2,1
"sela d",1022,1545.43128978991,247,102,1503.39321103572,164,71,1523.43140069127,47,22,1397.89880612234,34,8,1499.84769823407,2,1,1506.39552232181,83,31,1540.07347873652,193,83,1459.03312933706,54,19
"sell m",1023,1500.84942080171,2,1,1500.84942080171,2,1,1500,0,0,1500,0,0,1500,0,0,1500,0,0,1500.84942080171,2,1,1500,0,0
"seppi a",1024,1616.73925601297,599,288,1559.88802603272,294,130,1632.80685176318,80,46,1604.66921972427,206,107,1419.3710877273,19,5,1650.69700731193,305,158,1582.20228140562,506,243,1644.84277576751,93,45
"serdarusic n",1025,1488.46582001273,1,0,1500,0,0,1500,0,0,1488.36517550787,1,0,1500,0,0,1487.6501349427,1,0,1487.18745645056,1,0,1500,0,0
"sergeyev i",1026,1511.29766037738,2,1,1509.01178860661,2,1,1500,0,0,1500,0,0,1500,0,0,1500,0,0,1500,0,0,1507.62282143721,2,1
"serra f",1027,1464.63299142944,293,122,1443.90069803969,147,60,1435.57650306019,26,9,1526.48795304838,104,48,1453.2796701068,16,5,1494.67006798609,146,62,1471.67503400319,239,102,1457.74526680437,54,20
"serrano o",1028,1482.0851032293,8,3,1500,0,0,1500,0,0,1485.15762018709,8,3,1500,0,0,1481.95115285492,8,3,1492.05777619905,7,3,1487.05047029068,1,0
"setkic a",1029,1480.43225477776,2,0,1500,0,0,1500,0,0,1480.33541411386,2,0,1500,0,0,1480.79089874993,2,0,1479.39895078986,2,0,1500,0,0
"settergren j",1030,1483.21332805111,6,2,1474.9963106955,2,0,1500,0,0,1504.31482399519,4,2,1500,0,0,1501.87272708172,4,2,1483.06089432922,6,2,1500,0,0
"shane r",1031,1494.38248509124,1,0,1493.51444753221,1,0,1500,0,0,1500,0,0,1500,0,0,1500,0,0,1500,0,0,1492.26185971624,1,0
"shapovalov d",1032,1504.2475093427,3,1,1502.05947546965,3,1,1500,0,0,1500,0,0,1500,0,0,1500,0,0,1502.53333400779,3,1,1500,0,0
"sherwood d",1033,1505.1046905994,2,1,1500,0,0,1500.38395260895,2,1,1500,0,0,1500,0,0,1501.18613967649,2,1,1500,0,0,1502.05031063173,2,1
"shimada t",1034,1472.82937282679,2,0,1488.01155102301,1,0,1487.05047029068,1,0,1500,0,0,1500,0,0,1485.67578810007,1,0,1473.39367647432,2,0,1500,0,0
"shvec a",1035,1493.82972170154,1,0,1489.52014150152,1,0,1500,0,0,1500,0,0,1500,0,0,1500,0,0,1493.81917630055,1,0,1500,0,0
"shyla y",1036,1490.97496025721,1,0,1487.54445754548,1,0,1500,0,0,1500,0,0,1500,0,0,1500,0,0,1489.30913305527,1,0,1500,0,0
"si y m",1037,1486.97234538005,1,0,1487.0164582342,1,0,1500,0,0,1500,0,0,1500,0,0,1500,0,0,1486.96905616078,1,0,1500,0,0
"sidorenko a",1038,1487.11585027006,13,5,1482.58317401235,6,2,1500,0,0,1498.57215643073,7,3,1500,0,0,1496.66367538823,7,3,1496.74028753955,11,5,1481.88432020193,2,0
"siemerink j",1039,1421.45457336861,52,19,1461.7593757447,23,8,1459.87158128212,10,3,1462.79128206958,19,8,1500,0,0,1424.82050078729,29,11,1435.89940341183,43,17,1452.07657563226,9,2
"sijsling i",1040,1441.31320008652,133,47,1439.48762858414,77,27,1487.96916000902,23,10,1448.17912485511,33,10,1500,0,0,1456.19617260446,56,20,1458.73085351494,112,42,1425.45403592567,21,5
"silva d",1041,1485.80536279601,1,0,1500,0,0,1500,0,0,1487.3258006233,1,0,1500,0,0,1486.46709183235,1,0,1485.83434635196,1,0,1500,0,0
"silva f",1042,1485.86959583724,2,0,1500,0,0,1500,0,0,1481.1086245935,2,0,1500,0,0,1480.17450176638,2,0,1484.2660846081,2,0,1500,0,0
"silva j",1043,1440.77164874059,11,2,1474.16030041267,2,0,1500,0,0,1447.99685126115,9,2,1500,0,0,1451.23455729519,9,2,1458.10165066136,9,2,1473.12612885218,2,0
"simmonds p",1044,1479.98374165906,3,0,1473.3644263045,3,0,1500,0,0,1500,0,0,1500,0,0,1500,0,0,1483.3947468392,2,0,1488.41413266388,1,0
"simon g",1045,1760.25918096578,658,392,1728.1029526324,382,229,1614.73734597916,61,35,1671.96433435879,200,121,1505.7193384501,15,7,1697.72738250602,276,163,1742.34635647641,546,321,1719.88966553431,112,71
"simoni a",1046,1417.0052749834,30,10,1448.5370604126,15,5,1465.02136662538,5,1,1490.55648995554,10,4,1500,0,0,1450.33698671177,15,5,1426.47965521763,26,9,1474.52828280203,4,1
"simonsson f",1047,1487.5,1,0,1500,0,0,1500,0,0,1487.5,1,0,1500,0,0,1487.5,1,0,1487.5,1,0,1500,0,0
"singh n",1048,1487.82501490499,1,0,1487.69515676108,1,0,1500,0,0,1500,0,0,1500,0,0,1500,0,0,1487.8187975651,1,0,1500,0,0
"singh s",1049,1493.88661246773,1,0,1494.3151382754,1,0,1500,0,0,1500,0,0,1500,0,0,1500,0,0,1494.00501015847,1,0,1500,0,0
"sirianni j",1050,1485.13333889278,20,7,1492.00871996943,15,6,1464.70908371559,5,1,1500,0,0,1500,0,0,1469.20478003595,5,1,1491.21818130476,16,6,1480.71907167943,4,1
"siriluethaiwattana p",1051,1479.30254663445,2,0,1476.83997408918,2,0,1500,0,0,1500,0,0,1500,0,0,1500,0,0,1479.37444988635,2,0,1500,0,0
"sitak a",1052,1484.90267709961,1,0,1484.43058248124,1,0,1500,0,0,1500,0,0,1500,0,0,1500,0,0,1485.28318262821,1,0,1500,0,0
"skoch d",1053,1470.52929203148,3,0,1490.28167838924,1,0,1500,0,0,1479.67815754513,2,0,1500,0,0,1479.05904485271,2,0,1470.29106534708,3,0,1500,0,0
"skugor f",1054,1454.8450023304,16,4,1503.40907642502,3,1,1486.26861903051,1,0,1450.10258111566,11,3,1489.3096664715,1,0,1436.85314603308,13,3,1454.25395276427,15,4,1489.72342948898,1,0
"slabinsky a",1055,1481.49793543508,2,0,1500,0,0,1474.72595802818,2,0,1500,0,0,1500,0,0,1474.51388102991,2,0,1480.94501700774,2,0,1500,0,0
"slanar m",1056,1493.42384132654,3,1,1491.88873496587,3,1,1500,0,0,1500,0,0,1500,0,0,1500,0,0,1504.0309079396,2,1,1487.71930513305,1,0
"sluiter r",1057,1525.82869465771,197,84,1457.20238039533,80,31,1526.45624949314,45,23,1494.32312106592,63,26,1487.97460445618,9,4,1522.14673492317,117,53,1509.51752855976,160,72,1451.98161528826,37,12
"smeets r",1058,1460.4643360367,9,1,1457.69016595119,8,1,1500,0,0,1492.74168298333,1,0,1500,0,0,1495.25555535499,1,0,1461.96213078223,4,0,1482.54163344666,5,1
"smethurst d",1059,1496.33409564332,1,0,1500,0,0,1490.89256137284,1,0,1500,0,0,1500,0,0,1492.52663871566,1,0,1500,0,0,1492.16332004252,1,0
"smit j",1060,1485.00349582466,1,0,1485.01341037597,1,0,1500,0,0,1500,0,0,1500,0,0,1500,0,0,1485.40011534302,1,0,1500,0,0
"smith a",1061,1489.0874373924,1,0,1489.01017714534,1,0,1500,0,0,1500,0,0,1500,0,0,1500,0,0,1489.26857106867,1,0,1500,0,0
"smith j p",1062,1464.79628092139,17,5,1442.52079535703,10,1,1512.42340962389,7,4,1500,0,0,1500,0,0,1510.74816392645,7,4,1489.97054063107,14,5,1467.20172535571,3,0
"smith l",1063,1489.83981853261,1,0,1490.00012346342,1,0,1500,0,0,1500,0,0,1500,0,0,1500,0,0,1489.4791656253,1,0,1500,0,0
"smyczek t",1064,1519.58433589439,98,35,1509.8908632914,77,29,1461.66343213618,11,3,1474.95893782858,10,3,1500,0,0,1455.52717520161,21,6,1501.06353424454,79,28,1485.15657020918,19,7
"snobel p",1065,1465.75110120066,4,0,1469.29321203326,3,0,1489.45497146133,1,0,1500,0,0,1500,0,0,1490.78465985663,1,0,1483.88839263742,2,0,1472.99619053622,2,0
"sock j",1066,1841.12109254414,191,112,1783.35911291654,135,77,1562.35616427804,18,11,1650.60036696771,38,24,1500,0,0,1689.14041234409,56,35,1816.38226886053,153,90,1603.0574765976,38,22
"soderling r",1067,1974.65874459499,449,285,1911.71741300746,257,166,1638.54333180625,43,26,1842.79516355335,120,71,1633.9094543537,29,22,1886.92626641091,192,119,1950.13904000559,368,234,1768.44576902052,81,51
"soderlund c",1068,1505.00378793908,2,1,1500,0,0,1500,0,0,1503.90229504069,2,1,1500,0,0,1503.90289683474,2,1,1503.9713648634,2,1,1500,0,0
"soeda g",1069,1484.03221191569,98,28,1466.56017047732,75,23,1452.07078189484,15,4,1449.7565536793,8,1,1500,0,0,1436.20836546561,23,5,1478.10846494488,78,24,1447.62382935648,20,4
"sonego l",1070,1492.96502309946,1,0,1500,0,0,1500,0,0,1491.13497172012,1,0,1500,0,0,1491.79546955135,1,0,1492.23833127364,1,0,1500,0,0
"sorensen l",1071,1489.60471346081,6,2,1480.03583112527,4,1,1500,0,0,1501.91336299025,2,1,1500,0,0,1504.95545211436,2,1,1495.11954922317,3,1,1485.75302873049,3,1
"sousa j",1072,1634.29134668586,215,100,1585.24464507091,116,53,1500.73569124426,18,8,1614.3345137428,81,39,1500,0,0,1613.39962900126,99,47,1597.63566370918,185,85,1578.54137389145,30,15
"sousa p",1073,1454.41484995763,5,0,1500,0,0,1500,0,0,1450.29436326078,5,0,1500,0,0,1453.55202157355,5,0,1452.78341233933,5,0,1500,0,0
"sousa t",1074,1486.87270637075,1,0,1500,0,0,1500,0,0,1487.96247731529,1,0,1500,0,0,1487.07600149779,1,0,1487.18646251913,1,0,1500,0,0
"souza j",1075,1420.05564292571,68,24,1450.65471144895,8,1,1486.85726440696,1,0,1430.02968327785,59,23,1500,0,0,1422.94559771527,60,23,1439.93837606299,61,24,1425.40507378122,7,0
"spadea v",1076,1447.42334103038,368,168,1458.9964840686,235,110,1501.78713526141,46,22,1476.24433743475,65,26,1474.23767466189,22,10,1475.45795962947,133,58,1451.33593982545,316,148,1461.82508650314,52,20
"spottl m",1077,1476.30632494379,2,0,1487.5,1,0,1500,0,0,1487.94952970932,1,0,1500,0,0,1487.94952970932,1,0,1476.70801841533,2,0,1500,0,0
"spracklin t",1078,1485.25228539634,1,0,1485.88291963335,1,0,1500,0,0,1500,0,0,1500,0,0,1500,0,0,1485.48983246865,1,0,1500,0,0
"squillari f",1079,1552.97366785179,195,96,1506.12329445235,52,21,1451.71633544716,4,0,1540.84041042694,133,74,1454.43931200557,6,1,1528.14651675704,143,75,1555.47080536048,167,82,1488.01123232277,28,14
"srichaphan n",1080,1502.15302512681,4,2,1500,0,0,1500,0,0,1502.16275529977,2,1,1502.47346920802,2,1,1500.97101636352,4,2,1501.67393160514,4,2,1500,0,0
"srichaphan p",1081,1572.6125347899,375,204,1570.5597715388,276,161,1545.49326006863,39,21,1352.33410931113,40,9,1557.64382471271,20,13,1508.12322646703,99,43,1589.88047933467,323,180,1501.05541464709,52,24
"stadler s",1082,1508.04854090303,16,6,1498.16840539519,8,3,1487.95396111863,8,3,1500,0,0,1500,0,0,1497.02178641072,8,3,1497.25579591745,11,4,1495.16750467325,5,2
"stafford g",1083,1499.55219348043,2,1,1499.55219348043,2,1,1500,0,0,1500,0,0,1500,0,0,1500,0,0,1500,0,0,1500,2,1
"stakhovsky s",1084,1552.77518585005,305,133,1550.23042310845,179,77,1525.22708164018,43,21,1455.29216237426,65,24,1554.94999069687,18,11,1515.49867422375,126,56,1527.87408656545,254,113,1512.62559658997,51,20
"stanoytchev o",1085,1369.01062433697,28,7,1448.22854473991,9,2,1487.5,1,0,1417.35184336338,18,5,1500,0,0,1405.70681445918,19,5,1379.73389293871,24,6,1479.26530005594,4,1
"starace p",1086,1520.7493312003,334,146,1409.33182622386,79,22,1405.27935762306,12,1,1555.30896183546,230,119,1443.68403198291,13,4,1530.76733508467,255,124,1541.53902317957,292,137,1367.55311904248,42,9
"stark j",1087,1474.37479122087,2,0,1487.17747193893,1,0,1487.40845347911,1,0,1500,0,0,1500,0,0,1487.40016717474,1,0,1474.21317893801,2,0,1500,0,0
"statham j",1088,1474.65113526917,5,1,1465.53232359937,5,1,1500,0,0,1500,0,0,1500,0,0,1500,0,0,1474.68210750556,5,1,1500,0,0
"statham r",1089,1489.33090889039,1,0,1483.8838142572,1,0,1500,0,0,1500,0,0,1500,0,0,1500,0,0,1489.27384210045,1,0,1500,0,0
"stebe c m",1090,1533.95821168632,36,13,1473.79400277685,13,3,1486.28423034138,7,2,1550.44436205035,16,8,1500,0,0,1549.0147073441,23,10,1533.07430386983,28,11,1482.53259869802,8,2
"steckley r",1091,1487.20303419552,1,0,1487.77673863389,1,0,1500,0,0,1500,0,0,1500,0,0,1500,0,0,1487.79648076431,1,0,1500,0,0
"stepanek m",1092,1512.1003102319,2,1,1500,0,0,1500,0,0,1506.65508545392,2,1,1500,0,0,1509.51051187511,2,1,1511.64918500837,2,1,1500,0,0
"stepanek r",1093,1667.98964388997,631,358,1608.820085892,360,200,1625.69374617244,71,43,1609.4475694566,163,93,1575.89176740797,37,22,1658.3127662917,271,158,1691.64475510887,518,301,1525.23938827894,113,57
"stoliarov a",1094,1427.8998724788,87,32,1448.30029454161,42,17,1461.88311815985,17,6,1452.07757007465,23,8,1464.66413504982,5,1,1419.46322649315,45,15,1417.79517551589,75,27,1488.50929856017,12,5
"stoltenberg j",1095,1532.07469432337,49,28,1501.0251942206,32,17,1511.89564449752,7,4,1546.26053090058,10,7,1500,0,0,1556.24037403233,17,11,1544.23407602746,39,24,1481.72894874769,10,4
"stoppini a",1096,1489.95766755216,11,3,1498.76989606523,9,3,1500,0,0,1481.26289192144,2,0,1500,0,0,1479.66545706455,2,0,1491.12010531599,10,3,1496.90377907209,1,0
"strode b",1097,1487.94952970932,1,0,1487.94952970932,1,0,1500,0,0,1500,0,0,1500,0,0,1500,0,0,1487.94952970932,1,0,1500,0,0
"struff j l",1098,1549.97261788346,95,34,1569.82177264024,48,21,1437.20492587885,14,3,1443.11254012835,33,10,1500,0,0,1421.02767983596,47,13,1560.40618909087,79,31,1427.28957173124,16,3
"struvay e",1099,1475.92814902763,2,0,1500,0,0,1500,0,0,1477.06843657349,2,0,1500,0,0,1476.28648316495,2,0,1476.14958923018,2,0,1500,0,0
"sugita y",1100,1472.97110018635,40,11,1436.47378713761,27,6,1491.94554135986,10,4,1493.39236926691,3,1,1500,0,0,1489.83230124931,13,5,1472.11699151303,37,11,1475.78796418187,3,0
"sultan khalfan a",1101,1490.38938284428,1,0,1488.78401134285,1,0,1500,0,0,1500,0,0,1500,0,0,1500,0,0,1489.76981954596,1,0,1500,0,0
"summerer t",1102,1448.73362045916,9,1,1486.89495475926,2,0,1491.45831777655,1,0,1463.17748547569,6,1,1500,0,0,1459.53377291311,7,1,1457.36885698316,7,1,1476.71745155564,2,0
"sun p",1103,1462.58047459164,5,1,1462.05988491639,5,1,1500,0,0,1500,0,0,1500,0,0,1500,0,0,1462.14517802572,5,1,1500,0,0
"suzuki t",1104,1553.92128765903,37,18,1552.16856839704,34,17,1489.09726226904,3,1,1500,0,0,1500,0,0,1485.23577329702,3,1,1554.38638492218,31,16,1484.94216157935,6,2
"svarc l",1105,1477.59885080992,2,0,1488.44902321627,1,0,1500,0,0,1489.13181887852,1,0,1500,0,0,1487.88400320221,1,0,1489.74448674271,1,0,1488.03217388544,1,0
"sweeting r",1106,1558.56406347181,89,33,1488.85689084703,65,22,1476.44793366854,10,3,1542.35386871594,14,8,1500,0,0,1536.81537552217,24,11,1548.84487264467,71,28,1459.511530897,18,5
"syed f",1107,1484.54226786728,1,0,1486.13975426745,1,0,1500,0,0,1500,0,0,1500,0,0,1500,0,0,1484.60937995391,1,0,1500,0,0
"szymanski j",1108,1488.1922155324,1,0,1488.69340830561,1,0,1500,0,0,1500,0,0,1500,0,0,1500,0,0,1488.19673314412,1,0,1500,0,0
"tabara m",1109,1460.00697583874,79,33,1506.70014010827,40,18,1475.48415331792,2,0,1468.04430367183,32,13,1486.64132544484,5,2,1437.28100176719,39,15,1474.40422096685,62,28,1446.25670211395,17,5
"tahiri m",1110,1449.51273534534,7,1,1500,0,0,1500,0,0,1447.27402569673,7,1,1500,0,0,1446.11867617991,7,1,1448.40807796623,7,1,1500,0,0
"taino e",1111,1467.15496776051,26,10,1472.79574588317,22,9,1500,0,0,1478.58506891348,4,1,1500,0,0,1478.19295251222,4,1,1478.93060470032,24,10,1475.31307905549,2,0
"takeuchi k",1112,1486.28650825179,1,0,1486.03627698534,1,0,1500,0,0,1500,0,0,1500,0,0,1500,0,0,1486.30808201979,1,0,1500,0,0
"tarallo s",1113,1497.34881358258,2,1,1500,0,0,1500,0,0,1498.39713943389,2,1,1500,0,0,1498.04828254527,2,1,1497.92192895308,2,1,1500,0,0
"tarango j",1114,1347.86271107016,44,11,1348.29915124465,22,2,1477.58193262568,4,1,1484.57543021503,17,8,1489.58795610896,1,0,1455.18934728291,22,9,1365.6152972323,38,10,1455.7870665851,6,1
"tavares l",1115,1492.08054473373,3,1,1500,0,0,1500,0,0,1491.64332827661,3,1,1500,0,0,1490.71140649933,3,1,1491.68760672614,3,1,1500,0,0
"tearney f",1116,1492.2901035521,1,0,1492.43735169701,1,0,1500,0,0,1500,0,0,1500,0,0,1500,0,0,1490.80176854695,1,0,1500,0,0
"tebbutt m",1117,1486.92202501043,3,1,1487.75162174246,3,1,1500,0,0,1500,0,0,1500,0,0,1500,0,0,1486.29764739138,3,1,1500,0,0
"tecau h",1118,1487.97867502325,1,0,1488.23850716247,1,0,1500,0,0,1500,0,0,1500,0,0,1500,0,0,1487.41290591395,1,0,1500,0,0
"teixeira m",1119,1473.73624555031,6,1,1480.8152186634,2,0,1500,0,0,1487.59802498054,4,1,1500,0,0,1492.12888705017,4,1,1475.61288516059,3,0,1498.7459086013,3,1
"tenconi t",1120,1488.07133344089,3,1,1500,0,0,1500,0,0,1486.1578070642,3,1,1500,0,0,1484.95864880922,3,1,1496.97109383208,2,1,1490.47256858191,1,0
"terachi t",1121,1464.69375439256,11,4,1468.09882150941,11,4,1500,0,0,1500,0,0,1500,0,0,1500,0,0,1463.03167464944,11,4,1500,0,0
"thiem d",1122,1824.06681454002,199,120,1698.91628951624,100,52,1553.66296262302,17,9,1836.22761663601,82,59,1500,0,0,1839.78106154911,99,68,1793.29537853741,167,100,1634.4351670476,32,20
"thomann n",1123,1476.93947510259,37,14,1513.69185992014,18,8,1488.49185415075,3,1,1444.01350291794,7,1,1486.44793890556,9,4,1441.01647042379,19,6,1479.99395955682,33,13,1481.58440041203,4,1
"thomas j",1124,1473.72170424287,2,0,1485.14454530429,1,0,1488.36798559581,1,0,1500,0,0,1500,0,0,1488.3874797951,1,0,1473.74470516725,2,0,1500,0,0
"thompson c",1125,1488.15792869527,1,0,1500,0,0,1486.91923261276,1,0,1500,0,0,1500,0,0,1486.88696536831,1,0,1488.45568750074,1,0,1500,0,0
"thompson j",1126,1460.40006741665,14,3,1469.86207983769,9,2,1466.81503762489,3,0,1501.54800859254,2,1,1500,0,0,1472.09588241269,5,1,1491.37574905841,7,2,1449.13090429779,7,1
"thron a",1127,1475.85694662372,2,0,1483.96867072516,1,0,1500,0,0,1493.64054209828,1,0,1500,0,0,1492.78421866263,1,0,1476.25885685635,2,0,1500,0,0
"tiafoe f",1128,1438.60561178235,14,2,1450.02935235511,11,2,1500,0,0,1468.13423521405,3,0,1500,0,0,1468.24062750438,3,0,1447.94859869762,11,2,1475.91741452133,3,0
"tieleman l",1129,1446.06441673667,28,10,1494.50345137248,17,8,1465.09839119602,5,1,1455.72410694837,6,1,1500,0,0,1425.05963690615,11,2,1450.36277336447,25,9,1487.45935069303,3,1
"tiilikainen k",1130,1478.45638777046,2,0,1500,0,0,1500,0,0,1475.09420458815,2,0,1500,0,0,1475.80026215439,2,0,1478.5327210867,2,0,1500,0,0
"tillstrom m",1131,1495.98599244229,31,15,1511.45667438625,21,11,1474.55047029068,2,0,1507.01925243521,8,4,1500,0,0,1481.07119900592,10,4,1525.13386022284,26,14,1462.87220844559,5,1
"timfjord n",1132,1485.42546234492,1,0,1500,0,0,1500,0,0,1486.32849315979,1,0,1500,0,0,1485.93633815433,1,0,1485.92318548771,1,0,1500,0,0
"tipsarevic j",1133,1607.2933195969,449,234,1622.38636091828,269,144,1564.18578286415,60,33,1576.08204858076,98,46,1513.18392303554,22,11,1584.87676143599,180,90,1598.3709430478,355,184,1633.2794453235,94,50
"tkalec m",1134,1487.26556954312,1,0,1500,0,0,1500,0,0,1488.57725421373,1,0,1500,0,0,1488.51312285047,1,0,1487.25328171489,1,0,1500,0,0
"tobon m",1135,1498.16804677279,2,1,1500,0,0,1500,0,0,1500.06674213707,2,1,1500,0,0,1500.02841153771,2,1,1498.48792005081,2,1,1500,0,0
"todero n",1136,1488.57894727362,1,0,1500,0,0,1500,0,0,1488.1243563474,1,0,1500,0,0,1487.02440511659,1,0,1488.4581447844,1,0,1500,0,0
"tomashevich d",1137,1487.83240020639,1,0,1490.54136187308,1,0,1500,0,0,1500,0,0,1500,0,0,1500,0,0,1487.63855370341,1,0,1500,0,0
"tomic b",1138,1694.25772621192,276,142,1675.77962493549,182,97,1607.77791266421,43,24,1499.90489610794,51,21,1500,0,0,1618.37273492021,94,45,1673.00670972554,212,105,1654.6864034457,64,37
"tong m",1139,1488.53339301921,1,0,1486.4682441455,1,0,1500,0,0,1500,0,0,1500,0,0,1500,0,0,1487.58091064217,1,0,1500,0,0
"topic j",1140,1492.29600345342,1,0,1500,0,0,1500,0,0,1492.14325491083,1,0,1500,0,0,1491.33712268073,1,0,1492.47066472752,1,0,1500,0,0
"torebko p",1141,1489.55382072422,1,0,1500,0,0,1500,0,0,1488.51828820106,1,0,1500,0,0,1488.24469682552,1,0,1489.20748486274,1,0,1500,0,0
"tramacchi p",1142,1487.31839103294,1,0,1486.76061256292,1,0,1500,0,0,1500,0,0,1500,0,0,1500,0,0,1487.81971118125,1,0,1500,0,0
"travaglia s",1143,1488.8895069526,1,0,1500,0,0,1500,0,0,1488.66812956308,1,0,1500,0,0,1489.61779379837,1,0,1489.44540600709,1,0,1500,0,0
"traykov i",1144,1499.44561622705,2,1,1500,0,0,1500,0,0,1499.25618958016,2,1,1500,0,0,1498.09376852972,2,1,1499.9080120244,2,1,1500,0,0
"trevisan m",1145,1486.47052337244,1,0,1500,0,0,1500,0,0,1487.2635093253,1,0,1500,0,0,1486.13863314458,1,0,1486.91214145019,1,0,1500,0,0
"trifu g",1146,1458.0011635139,8,2,1500,0,0,1475.88649878002,2,0,1481.98609728881,6,2,1500,0,0,1456.95719578554,8,2,1457.82628757425,8,2,1500,0,0
"trimmel c",1147,1479.56343068997,2,0,1500,0,0,1500,0,0,1479.21522613043,2,0,1500,0,0,1479.14149028635,2,0,1479.5757000899,2,0,1500,0,0
"trinker b",1148,1505.17379269202,3,1,1500,0,0,1500,0,0,1506.3015126694,3,1,1500,0,0,1505.81260174219,3,1,1505.28156755605,3,1,1500,0,0
"troicki v",1149,1710.14061490922,438,233,1671.58133310874,273,148,1586.65457898791,50,28,1620.69151749425,103,51,1518.05477893107,12,6,1648.09490510855,165,85,1685.03291041609,365,190,1640.83299321622,73,43
"trongcharoenchaikul w",1150,1490.77840199309,1,0,1490.71472736689,1,0,1500,0,0,1500,0,0,1500,0,0,1500,0,0,1491.28185787296,1,0,1500,0,0
"trujillo g",1151,1506.54668002995,2,1,1500,0,0,1500,0,0,1508.291123297,2,1,1500,0,0,1507.75237082757,2,1,1506.03002902777,2,1,1500,0,0
"trungelliti m",1152,1501.06038598551,10,4,1497.90644330677,3,1,1500,0,0,1498.21552735889,7,3,1500,0,0,1499.68150080197,7,3,1478.07594605092,6,2,1512.30120935795,4,2
"trusendi w",1153,1486.94084374307,1,0,1500,0,0,1500,0,0,1485.38543031198,1,0,1500,0,0,1486.39210151727,1,0,1486.80450116915,1,0,1500,0,0
"tsonga j w",1154,1929.6228896896,534,363,1872.20337636113,354,244,1730.07455393775,57,41,1761.34585265785,105,66,1590.81907108988,18,12,1813.90892077066,180,119,1865.02701103435,391,255,1866.28792593982,143,108
"tuksar s",1155,1455.34114915909,7,1,1485.81544501885,1,0,1500,0,0,1466.68293893496,6,1,1500,0,0,1465.12966889233,6,1,1467.47259495997,5,1,1479.11029638886,2,0
"tursunov d",1156,1565.81269691735,424,219,1583.91297980674,267,144,1553.03830106875,63,37,1503.24168694339,71,28,1476.87061230003,23,10,1532.24086356446,157,75,1592.91337960443,343,181,1466.32913140326,81,38
"tveit e",1157,1491.56604864934,1,0,1500,0,0,1500,0,0,1492.42144116355,1,0,1500,0,0,1491.77526781015,1,0,1489.27170446858,1,0,1500,0,0
"uchiyama y",1158,1483.79945743398,2,0,1481.62691160681,2,0,1500,0,0,1500,0,0,1500,0,0,1500,0,0,1482.86225588954,2,0,1500,0,0
"udomchoke d",1159,1349.4361512846,69,17,1356.22145876709,49,12,1446.57113418007,16,5,1464.28925754464,4,0,1500,0,0,1426.32970956802,20,5,1343.31331543708,55,13,1465.66074228893,14,4
"uebel l",1160,1496.82943915837,1,0,1500,0,0,1487.81856465441,1,0,1500,0,0,1500,0,0,1497.23987698988,1,0,1496.96978137367,1,0,1500,0,0
"ulihrach b",1161,1457.89015196607,191,86,1536.64335739036,89,43,1447.12340055854,10,2,1442.36469997813,76,34,1473.4630998236,16,7,1410.28270184025,102,43,1455.44194589954,165,79,1426.68874930818,26,7
"ullyett k",1162,1462.07816215663,7,2,1461.45495234338,7,2,1500,0,0,1500,0,0,1500,0,0,1500,0,0,1462.49726102715,5,1,1500,2,1
"ungur a",1163,1405.35493828158,33,6,1456.10053723574,5,0,1468.06294234074,3,0,1433.13939683737,25,6,1500,0,0,1414.36690620821,28,6,1430.34549087633,25,5,1448.47199757226,8,1
"uppal v",1164,1485.08306131825,1,0,1485.5209667282,1,0,1500,0,0,1500,0,0,1500,0,0,1500,0,0,1485.51531893953,1,0,1500,0,0
"urban f",1165,1475.35682626692,2,0,1500,0,0,1500,0,0,1473.12199775065,2,0,1500,0,0,1474.27964379124,2,0,1475.86653170195,2,0,1500,0,0
"vacek d",1166,1388.47194976748,29,6,1420.80532315729,23,6,1482.89498086892,2,0,1452.46239729828,4,0,1500,0,0,1438.04811962268,6,0,1393.90709790042,24,5,1472.10739701483,5,1
"vacek j",1167,1446.63841659068,88,30,1365.33437234507,44,12,1518.74421518684,29,14,1447.65323783475,15,4,1500,0,0,1506.71556364816,44,18,1454.09702577493,73,26,1445.65310952178,15,4
"vagnozzi s",1168,1494.95785998237,11,4,1500,0,0,1500,0,0,1492.95004210524,11,4,1500,0,0,1491.20887943205,11,4,1493.31734032905,11,4,1500,0,0
"vahaly b",1169,1399.41991644521,64,21,1417.48154082943,47,17,1463.70103149237,10,3,1448.2151996685,7,1,1500,0,0,1426.87801138956,17,4,1404.2504957429,56,20,1461.31050489151,8,1
"vaisse m",1170,1491.50707689348,1,0,1500,0,0,1500,0,0,1485.10665502378,1,0,1500,0,0,1491.59379894113,1,0,1491.65977670099,1,0,1500,0,0
"vajda i",1171,1478.19932666368,2,0,1500,0,0,1500,0,0,1478.15490292748,2,0,1500,0,0,1477.7128723409,2,0,1479.32609285462,2,0,1500,0,0
"valent r",1172,1491.17279307752,1,0,1489.46788974122,1,0,1500,0,0,1500,0,0,1500,0,0,1500,0,0,1489.90672467788,1,0,1500,0,0
"van d merwe i",1173,1485.68812917924,1,0,1485.69211588783,1,0,1500,0,0,1500,0,0,1500,0,0,1500,0,0,1486.16793693824,1,0,1500,0,0
"van der dium a",1174,1483.77295120374,1,0,1484.84281816003,1,0,1500,0,0,1500,0,0,1500,0,0,1500,0,0,1483.4575026173,1,0,1500,0,0
"van der meer n",1175,1490.44654451967,1,0,1500,0,0,1500,0,0,1491.43165725054,1,0,1500,0,0,1489.76223465612,1,0,1490.61648069161,1,0,1500,0,0
"van der merwe i",1176,1523.83392650691,13,7,1506.14127588359,9,5,1501.45970058183,4,2,1500,0,0,1500,0,0,1502.97239795814,4,2,1530.39342690322,12,7,1486.81246672675,1,0
"van gemerden m",1177,1495.71449401327,10,4,1493.95825309868,3,1,1501.76234779421,2,1,1499.23799129038,5,2,1500,0,0,1498.32881059674,7,3,1509.09404667773,6,3,1480.82695161476,4,1
"van lottum j",1178,1402.78916693191,68,20,1410.20938387952,34,8,1462.19307395759,12,4,1461.70607858654,22,8,1500,0,0,1434.26850001871,34,12,1418.63103734275,53,17,1425.90774227585,15,3
"van rijthoven t",1179,1491.82303395192,1,0,1486.64606289706,1,0,1500,0,0,1500,0,0,1500,0,0,1500,0,0,1490.68760907279,1,0,1500,0,0
"van scheppingen d",1180,1445.48408640187,47,16,1465.7507410444,20,7,1459.30739308623,10,3,1467.2339656775,17,6,1500,0,0,1443.07953650107,27,9,1461.80603653548,43,16,1460.06559304377,4,0
"vanek j",1181,1445.62185411383,184,66,1408.6380551265,58,18,1445.42183191785,8,1,1491.87246289358,111,47,1422.75685887425,7,0,1452.85288180567,126,48,1445.15658742267,155,61,1376.25990236037,29,5
"vanni l",1182,1447.09228965689,19,5,1452.42991036784,7,1,1484.59708337923,1,0,1484.04146352311,11,4,1500,0,0,1474.22169342641,12,4,1460.14766095878,17,5,1478.07248936144,2,0
"vardhan v",1183,1480.6572182197,2,0,1478.69998176893,2,0,1500,0,0,1500,0,0,1500,0,0,1500,0,0,1479.75461208389,2,0,1500,0,0
"varlet j",1184,1475.56473961187,11,3,1456.5488161017,4,0,1500,0,0,1482.05989047763,4,1,1514.45722371128,3,2,1503.03199481484,7,3,1476.04736370141,7,2,1479.84400905029,4,1
"vasek r",1185,1487.49579726783,1,0,1500,0,0,1500,0,0,1487.33335948028,1,0,1500,0,0,1487.36071422101,1,0,1487.12994468016,1,0,1500,0,0
"vasilevski a",1186,1487.63007121472,1,0,1487.89763114836,1,0,1500,0,0,1500,0,0,1500,0,0,1500,0,0,1487.43144517624,1,0,1500,0,0
"vassallo arguello m",1187,1426.23527240905,126,47,1380.56715741662,26,4,1468.91149894242,7,2,1496.67863382051,93,41,1500,0,0,1490.73031186039,100,43,1435.95793944668,102,39,1448.26077071427,24,8
"vega hernandez d",1188,1487.04043064518,1,0,1500,0,0,1500,0,0,1487.08821035985,1,0,1500,0,0,1487.26823455216,1,0,1486.77261046073,1,0,1500,0,0
"veger f",1189,1490.55368321768,1,0,1486.77213500305,1,0,1500,0,0,1500,0,0,1500,0,0,1500,0,0,1489.2065211453,1,0,1500,0,0
"veic a",1190,1447.61888509893,32,10,1458.26774685048,11,3,1500,0,0,1455.03160858598,18,5,1510.41962907189,3,2,1464.9809696492,21,7,1416.05242596247,27,7,1533.87415341611,5,3
"velotti a",1191,1474.0889903065,3,0,1500,0,0,1500,0,0,1473.0634571574,3,0,1500,0,0,1472.82502430606,3,0,1474.22085975419,3,0,1500,0,0
"vemic d",1192,1491.94228351817,21,9,1477.65773778416,5,1,1501.58823759276,6,3,1509.59143348256,10,5,1500,0,0,1500.63689731976,16,8,1501.36936283265,20,9,1486.11885743406,1,0
"ventura s",1193,1428.15716874513,97,38,1407.71119534154,12,1,1421.76447361663,7,0,1493.34690461836,78,37,1500,0,0,1446.46998955681,85,37,1462.02153384384,86,37,1408.83216281194,11,1
"venus m",1194,1454.97106257512,8,1,1455.72020935709,7,1,1500,0,0,1486.94251661269,1,0,1500,0,0,1487.4826088143,1,0,1451.13319938313,8,1,1500,0,0
"verdasco f",1195,1665.10229109726,776,448,1598.68930485206,372,200,1605.21095436873,74,44,1684.699595485,308,192,1531.70943127169,22,12,1685.77808025994,404,248,1643.5359545175,627,354,1669.64194722282,149,94
"verdasco m",1196,1511.20046839112,2,1,1500,0,0,1500,0,0,1504.793628953,2,1,1500,0,0,1508.44200181645,2,1,1509.92966212399,2,1,1500,0,0
"verkerk m",1197,1495.39606369699,117,54,1456.33147857131,42,15,1470.92872430598,9,3,1540.84628401001,54,28,1557.29055723255,12,8,1518.94138616976,75,39,1488.84332890851,98,44,1529.96999168317,19,10
"veronelli d",1198,1493.89233644646,5,2,1489.83916741541,1,0,1500,0,0,1502.12619741212,4,2,1500,0,0,1503.1630724988,4,2,1492.12827672433,5,2,1500,0,0
"vesely j",1199,1664.85135279363,128,58,1543.96514692664,59,25,1532.74991584576,16,9,1587.31321779921,53,24,1500,0,0,1621.22310118893,69,33,1625.50501656618,105,48,1522.68177458524,23,10
"vicente f",1200,1358.33578508764,248,100,1437.07355974826,83,33,1449.47190942456,15,4,1407.27421082103,142,62,1441.17846774213,8,1,1387.77467524989,165,67,1373.43819859054,206,82,1459.83925799326,42,18
"vicente m",1201,1487.85421147403,1,0,1500,0,0,1500,0,0,1488.25046056234,1,0,1500,0,0,1485.8984945812,1,0,1488.43757138981,1,0,1500,0,0
"vico u",1202,1481.99892493334,7,2,1501.6485793474,4,2,1492.46448352376,1,0,1492.08400949723,1,0,1487.10973685201,1,0,1470.40361851966,3,0,1481.75656162185,7,2,1500,0,0
"vik r",1203,1449.51396258799,55,19,1473.42300227459,21,6,1469.51989434631,5,1,1497.62369664508,20,8,1495.3292481667,9,4,1461.2644178689,34,13,1460.18454230628,48,18,1461.81535870072,7,1
"viloca j a",1204,1504.24237537714,12,6,1506.13287616209,6,3,1500,0,0,1502.13057943772,6,3,1500,0,0,1501.12503110495,6,3,1505.24226379962,12,6,1500,0,0
"vinciguerra a",1205,1503.53653731766,153,73,1494.52258677798,83,42,1465.69699579516,7,2,1499.12452751437,55,24,1530.99108102263,8,5,1503.38504051142,70,31,1495.60637263929,127,61,1490.9339869501,26,12
"vinck c",1206,1377.02948830962,36,10,1435.21065856816,16,4,1499.99648432736,8,4,1439.34047873717,10,2,1474.13742003437,2,0,1415.61128781268,20,6,1373.15844991439,29,7,1488.94240418887,7,3
"viola m",1207,1491.29640057493,13,4,1502.24215170194,6,2,1488.5052305593,1,0,1478.59350360137,6,2,1500,0,0,1469.56148602378,7,2,1487.33796769212,13,4,1500,0,0
"viola mat",1208,1483.50950153308,2,0,1477.84507406775,2,0,1500,0,0,1500,0,0,1500,0,0,1500,0,0,1489.14314687015,1,0,1485.2079875006,1,0
"vlasov d",1209,1489.94431257746,1,0,1500,0,0,1500,0,0,1491.39293963992,1,0,1500,0,0,1490.26881774682,1,0,1490.29750657373,1,0,1500,0,0
"vliegen k",1210,1472.50653649059,196,83,1463.71148590061,84,36,1452.98384543025,27,10,1503.62607222447,72,31,1489.48436540215,13,6,1481.54954481028,112,47,1510.73648491995,164,74,1396.39233401687,32,9
"voinea a",1211,1435.48624709994,116,46,1486.71662601704,53,23,1469.90120149317,11,4,1438.09815395967,48,18,1478.81561128495,4,1,1416.81455205489,63,23,1428.06965598592,94,36,1481.97771050663,22,10
"volandri f",1212,1358.84871387432,381,167,1272.36597745757,63,8,1415.57018411744,13,2,1409.29054260396,290,154,1414.60585563828,15,3,1398.71904880692,318,159,1377.9773384038,337,158,1345.5833533019,44,9
"voltchkov v",1213,1472.71118035451,103,45,1500.10110023791,65,31,1488.64655621221,17,8,1432.37615595236,10,1,1490.61235520168,11,5,1435.53095767836,38,14,1478.4676292776,84,37,1480.05782118087,19,8
"vovk s",1214,1487.60121587913,1,0,1487.97091826924,1,0,1500,0,0,1500,0,0,1500,0,0,1500,0,0,1487.98121673066,1,0,1500,0,0
"wachiramanowong k",1215,1483.99859635002,3,0,1477.26288880472,3,0,1500,0,0,1500,0,0,1500,0,0,1500,0,0,1481.24002827805,3,0,1500,0,0
"wagh a",1216,1493.4661643123,1,0,1492.73668065591,1,0,1500,0,0,1500,0,0,1500,0,0,1500,0,0,1492.11858553978,1,0,1500,0,0
"walter l",1217,1485.4737384903,1,0,1500,0,0,1485.42615892641,1,0,1500,0,0,1500,0,0,1486.03544065139,1,0,1486.04715413648,1,0,1500,0,0
"wang c",1218,1508.51917265121,2,1,1505.94120966825,2,1,1500,0,0,1500,0,0,1500,0,0,1500,0,0,1507.99912044452,2,1,1500,0,0
"wang j",1219,1511.3872211153,21,8,1491.36502686831,7,2,1496.4089493258,10,4,1499.30177904087,4,2,1500,0,0,1510.42855854443,14,6,1480.7537254312,11,4,1514.20253962492,10,4
"wang y",1220,1463.19183120551,4,0,1468.72756294835,3,0,1500,0,0,1490.68387346806,1,0,1500,0,0,1490.05545654565,1,0,1461.65447596328,4,0,1500,0,0
"wang y jr",1221,1486.63081220442,3,1,1485.66751652827,3,1,1500,0,0,1500,0,0,1500,0,0,1500,0,0,1486.6109108472,3,1,1500,0,0
"wang y t",1222,1506.49830216745,40,14,1494.36710352964,25,9,1492.86625639092,12,5,1467.96178167455,3,0,1500,0,0,1478.54251336254,15,5,1491.43704910508,30,11,1478.82063687898,10,3
"warburg s",1223,1492.15004635799,15,5,1478.85634915783,14,5,1489.86863642855,1,0,1500,0,0,1500,0,0,1490.99750431811,1,0,1477.89541190925,10,3,1494.79168915847,5,2
"ward a",1224,1477.46865356925,3,0,1500,0,0,1476.744008181,2,0,1493.32563050384,1,0,1500,0,0,1474.96749716814,3,0,1480.88525265591,2,0,1492.14063074624,1,0
"ward j",1225,1427.11587182709,59,15,1433.14749011904,17,3,1417.48766400661,36,11,1454.32194698654,6,1,1500,0,0,1413.97918155349,42,12,1416.18445465916,45,12,1451.70328231565,14,3
"washington m",1226,1464.95008737499,5,1,1466.22415882437,5,1,1500,0,0,1500,0,0,1500,0,0,1500,0,0,1465.15549030131,5,1,1500,0,0
"waske a",1227,1442.46122724788,89,27,1412.11245516694,29,8,1439.35174561566,15,4,1460.99444225989,41,14,1480.39375491602,4,1,1449.94894201836,60,19,1457.34236246963,76,25,1416.64803799196,13,2
"wassen r",1228,1466.76874317945,8,2,1499.65100888334,2,1,1488.39731929921,1,0,1474.28586080817,5,1,1500,0,0,1460.97494521915,6,1,1467.41378657995,8,2,1500,0,0
"wawrinka s",1229,1917.87857708341,652,416,1880.10326393728,355,228,1610.5763681303,48,26,1899.67452153801,229,153,1499.63295214333,20,9,1872.24431170344,297,188,1822.05135223105,489,298,1951.4709701414,163,118
"weiner g",1230,1436.10731499569,30,10,1432.75415568498,25,8,1490.56849111197,5,2,1500,0,0,1500,0,0,1487.99179771896,5,2,1439.35553842681,26,9,1475.47742416089,4,1
"weintraub a",1231,1470.39080162894,5,1,1477.0888301523,4,1,1487.05627399953,1,0,1500,0,0,1500,0,0,1486.95765756104,1,0,1464.88427294028,3,0,1504.48801051262,2,1
"weinzierl j",1232,1485.60595154768,1,0,1500,0,0,1500,0,0,1486.99670561306,1,0,1500,0,0,1486.38346785554,1,0,1485.56460478648,1,0,1500,0,0
"wessels l",1233,1504.01224930386,2,1,1500,0,0,1500,0,0,1502.7611071488,2,1,1500,0,0,1501.84552342876,2,1,1504.67158537465,2,1,1500,0,0
"wessels p",1234,1521.01898172464,66,30,1439.01075130099,36,13,1567.17205933142,23,15,1474.80140839488,7,2,1500,0,0,1558.30821139885,30,17,1519.05657006095,55,27,1463.60650775367,11,3
"westerhof b",1235,1487.82833351354,1,0,1500,0,0,1500,0,0,1486.47770909104,1,0,1500,0,0,1486.41506658138,1,0,1488.33784134039,1,0,1500,0,0
"wheaton d",1236,1483.37208288301,4,1,1476.81992904684,2,0,1499.55047029068,2,1,1500,0,0,1500,0,0,1501.77623486336,2,1,1482.91839130946,4,1,1500,0,0
"whitehouse w",1237,1489.60189675415,10,4,1496.59897907745,7,3,1494.78534296338,3,1,1500,0,0,1500,0,0,1491.63360535716,3,1,1487.9370020412,10,4,1500,0,0
"whittington a",1238,1507.91079244909,2,1,1507.08335489575,2,1,1500,0,0,1500,0,0,1500,0,0,1500,0,0,1507.5295372626,2,1,1500,0,0
"widom t",1239,1524.68508835059,10,5,1519.12696763981,10,5,1500,0,0,1500,0,0,1500,0,0,1500,0,0,1523.02912483764,10,5,1500,0,0
"willems r",1240,1500.90466303186,2,1,1500,0,0,1500,0,0,1500,2,1,1500,0,0,1500,2,1,1500.55231072213,2,1,1500,0,0
"williams r",1241,1462.17131867625,25,7,1464.47031426506,17,4,1480.42438720047,2,0,1501.90154715334,6,3,1500,0,0,1482.85889723093,8,3,1482.23597408266,20,7,1462.4986925615,5,0
"willis m",1242,1512.38971922056,2,1,1500,0,0,1507.80660840537,2,1,1500,0,0,1500,0,0,1506.87804570179,2,1,1500,0,0,1510.85909628378,2,1
"willman d",1243,1490.81303580967,1,0,1489.84446145466,1,0,1500,0,0,1500,0,0,1500,0,0,1500,0,0,1490.81031970907,1,0,1500,0,0
"wilson b",1244,1469.04581677331,5,1,1475.62769550189,4,1,1487.5,1,0,1500,0,0,1500,0,0,1487.56189193517,1,0,1477.87571933283,4,1,1489.35820027918,1,0
"wiltschnig h",1245,1473.10274826107,4,1,1500,0,0,1500,0,0,1475.60027306286,4,1,1500,0,0,1474.89446688486,4,1,1472.74738210104,4,1,1500,0,0
"witt a",1246,1485.33285954229,1,0,1500,0,0,1487.5,1,0,1500,0,0,1500,0,0,1486.59834438393,1,0,1485.72465410557,1,0,1500,0,0
"witten j",1247,1481.3586106431,10,2,1491.98158723742,7,2,1492.04947840587,1,0,1476.78366619173,2,0,1500,0,0,1474.62716806053,3,0,1464.66495054966,4,0,1491.88172054284,6,2
"wolmarans f",1248,1490.61772366555,3,1,1489.55962468562,3,1,1500,0,0,1500,0,0,1500,0,0,1500,0,0,1491.47848925789,3,1,1500,0,0
"woodbridge t",1249,1466.56353731896,20,8,1443.14208754419,11,3,1512.76366205911,7,4,1499.55271256477,2,1,1500,0,0,1513.00134669422,9,5,1474.24417709297,13,5,1485.5566284931,7,3
"woodforde m",1250,1462.99433420696,10,3,1468.21621345414,9,3,1487.5,1,0,1500,0,0,1500,0,0,1493.03931360787,1,0,1465.07128526565,7,2,1491.24787646698,3,1
"woodruff c",1251,1458.24818595395,69,29,1491.35062194715,51,24,1481.51202653305,6,2,1430.19998339326,10,2,1499.99887807091,2,1,1434.11139870276,18,5,1436.46978065422,52,20,1516.25979596742,17,9
"wu d",1252,1445.99547459912,17,2,1430.14928917631,17,2,1500,0,0,1500,0,0,1500,0,0,1500,0,0,1465.58423956293,14,2,1461.55811056649,3,0
"xu j c",1253,1485.71362176404,1,0,1486.14712061416,1,0,1500,0,0,1500,0,0,1500,0,0,1500,0,0,1486.52108273276,1,0,1500,0,0
"yang t h",1254,1474.51605154047,4,0,1467.71609554835,4,0,1500,0,0,1500,0,0,1500,0,0,1500,0,0,1472.8054985103,4,0,1500,0,0
"yani m",1255,1447.56537693016,17,4,1437.36969582057,9,1,1521.19188535788,5,3,1462.70948090146,3,0,1500,0,0,1486.14387140246,8,3,1473.19628801749,13,4,1452.60756837,4,0
"yim r",1256,1486.1212138449,2,0,1484.03443961896,2,0,1500,0,0,1500,0,0,1500,0,0,1500,0,0,1491.41423792381,1,0,1490.31898778106,1,0
"ymer e",1257,1449.0583402524,24,6,1436.08890584285,8,1,1492.64888740418,1,0,1485.98940428571,15,5,1500,0,0,1481.56065101323,16,5,1472.84209534263,20,6,1450.83949835933,4,0
"ymer m",1258,1504.45238727703,3,1,1498.10569230561,3,1,1500,0,0,1500,0,0,1500,0,0,1500,0,0,1503.01147115642,3,1,1500,0,0
"yoo d",1259,1488.94209514641,1,0,1500,0,0,1500,0,0,1488.69820677785,1,0,1500,0,0,1488.98941517702,1,0,1488.98483721134,1,0,1500,0,0
"yoon y",1260,1490.42085238165,7,3,1497.44390046751,6,3,1489.14061342703,1,0,1500,0,0,1500,0,0,1491.08656964013,1,0,1495.95644590563,6,3,1491.80336369198,1,0
"young d",1261,1620.83057831157,246,96,1599.80041647568,190,79,1449.55763557282,29,10,1437.67099852961,27,7,1500,0,0,1459.30291129551,56,17,1602.79892048037,199,79,1483.95911007264,47,17
"youzhny a",1262,1519.92068680684,5,2,1508.92278536988,5,2,1500,0,0,1500,0,0,1500,0,0,1500,0,0,1517.71226073066,5,2,1500,0,0
"youzhny m",1263,1607.04185984823,813,457,1613.52734362664,419,237,1619.83577538309,97,59,1511.25120412679,236,123,1580.25908846647,61,38,1545.99648827424,394,220,1581.98142515255,654,358,1632.92124958579,159,99
"yu x y",1264,1470.89706773947,2,0,1471.85491227536,2,0,1500,0,0,1500,0,0,1500,0,0,1500,0,0,1470.7393172257,2,0,1500,0,0
"zabaleta m",1265,1534.4619833543,297,145,1454.91597697098,102,40,1445.18944161515,5,0,1594.00971224015,185,104,1465.24539823863,5,1,1570.33457174269,195,105,1596.07814583192,255,128,1435.61396701762,42,17
"zampieri c",1266,1494.84246060057,3,1,1500,0,0,1500,0,0,1496.65058050749,3,1,1500,0,0,1494.37424408915,3,1,1496.57731152402,3,1,1500,0,0
"zayed m s",1267,1495.46030445088,2,0,1495.03391726143,2,0,1500,0,0,1500,0,0,1500,0,0,1500,0,0,1494.74555040305,2,0,1500,0,0
"zayid m s",1268,1494.16474092451,1,0,1493.05323554451,1,0,1500,0,0,1500,0,0,1500,0,0,1500,0,0,1492.64758895908,1,0,1500,0,0
"zeballos h",1269,1504.2888215073,152,57,1500.47211315362,60,22,1422.57858322992,9,1,1474.90733398928,83,34,1500,0,0,1438.38196156779,92,35,1509.85212626627,131,52,1418.98607637898,21,5
"zemlja g",1270,1579.58116527933,64,28,1518.34907999262,36,15,1503.54579337921,13,6,1519.50793031695,15,7,1500,0,0,1547.24666400493,28,13,1542.75058260785,45,20,1506.41437176116,19,8
"zeng s x",1271,1481.38688914292,6,1,1471.08917435547,6,1,1500,0,0,1500,0,0,1500,0,0,1500,0,0,1477.00584802195,6,1,1500,0,0
"zhang y",1272,1487.18987476134,1,0,1486.74045106283,1,0,1500,0,0,1500,0,0,1500,0,0,1500,0,0,1487.02527902609,1,0,1500,0,0
"zhang z",1273,1491.92887891303,15,4,1473.31000360995,13,3,1501.09243321212,2,1,1500,0,0,1500,0,0,1504.21964503033,2,1,1500.17856734702,13,4,1487.36489159231,2,0
"zhang ze",1274,1476.28329812735,7,1,1470.01055992936,7,1,1500,0,0,1500,0,0,1500,0,0,1500,0,0,1474.05799519821,7,1,1500,0,0
"zhang zh",1275,1502.9361707382,2,1,1500.83082665844,2,1,1500,0,0,1500,0,0,1500,0,0,1500,0,0,1502.14869324885,2,1,1500,0,0
"zhu b q",1276,1463.47631537115,5,1,1467.58905759406,5,1,1500,0,0,1500,0,0,1500,0,0,1500,0,0,1463.53284640114,5,1,1500,0,0
"ziadi m",1277,1448.87703353618,5,0,1500,0,0,1500,0,0,1447.96718526435,5,0,1500,0,0,1446.81395778454,5,0,1447.30060973171,5,0,1500,0,0
"zib t",1278,1420.26234581677,126,37,1398.32267585739,57,17,1470.47811211851,16,6,1419.52490725568,46,13,1455.34616064721,7,1,1423.58792347978,69,20,1406.23652762603,108,33,1436.16677405882,18,4
"zimonjic n",1279,1462.69450039435,16,4,1465.60691461373,3,0,1506.23586161223,4,2,1474.42472987102,5,1,1478.37713156603,4,1,1471.28247741449,13,4,1467.79882184988,15,4,1486.30393074448,1,0
"zitko r",1280,1475.10947846811,2,0,1486.72442235371,1,0,1500,0,0,1487.22259880621,1,0,1500,0,0,1486.78038458055,1,0,1474.5643573296,2,0,1500,0,0
"zlatanovic a",1281,1486.27446426663,1,0,1500,0,0,1500,0,0,1486.46594840494,1,0,1500,0,0,1485.65126131383,1,0,1485.46520860124,1,0,1500,0,0
"zopp j",1282,1459.84990604198,34,10,1477.86787262866,17,5,1462.73598904367,3,0,1474.25272852296,14,5,1500,0,0,1457.47490585889,17,5,1463.60342482453,23,8,1458.944648444,11,2
"zovko l",1283,1478.1998908075,8,2,1489.95166425498,3,1,1500,0,0,1481.1619109025,2,0,1493.4964940074,3,1,1482.02862852878,5,1,1477.81977875453,8,2,1500,0,0
"zverev a",1284,1813.39045735184,108,62,1721.78783379157,54,30,1589.12667221481,17,11,1631.74290906746,37,21,1500,0,0,1687.0855151224,54,32,1796.84274044672,96,56,1530.06665935948,12,6
"zverev m",1285,1614.66923790112,203,80,1591.77926476591,109,44,1500.07339026669,34,15,1401.84444234774,48,14,1524.82266525373,12,7,1461.71895720064,94,36,1595.45013649264,181,75,1411.91938171648,22,5
