"Players","Ratings","games","Hard_Ratings","Hard_games","Grass_Ratings","Grass_games","Clay_Ratings","Clay_games","Carpet_Ratings","Carpet_games","NotHard_Ratings","NotHard_games","Bo3_Ratings","Bo3_games","Bo5_Ratings","Bo5_games","Bo5Played","Bo5Won","Bo5PlusScore","Bo3Played","Bo3Won","Bo3PlusScore"
"Dosedel S.",1429.10475884282,57,1458.48036789507,30,1504.8401574747,4,1439.99066466101,23,1500,0,1441.70782451798,27,1414.47478098275,41,1497.40599641317,16,16,8,1.29420493666245,41,14,-4.13001458294983
"Enqvist T.",1511.37551725976,228,1542.28620302863,159,1508.25928705593,22,1482.43699581693,47,1500,0,1478.4929254159,69,1518.43494292858,177,1526.29750265108,51,51,28,-0.354712719543378,177,97,0.80973340993396
"Escude N.",1691.15951255038,160,1690.82279582848,104,1564.23699954426,28,1474.07813195154,28,1500,0,1553.59573174853,56,1663.7927292635,123,1582.82745464529,37,37,22,0.82343775928695,123,74,6.82294274272843
"Federer R.",2101.46328037056,1164,2139.95798061969,737,1929.78899649866,165,1898.40571166659,262,1500,0,1947.7529451158,427,2071.95172277686,787,1999.48430860098,377,377,322,12.7335625354038,787,640,11.3249686794187
"Fromberg R.",1414.08589293092,49,1487.81720629224,26,1499.95374611327,4,1412.98159827556,19,1500,0,1412.75969550366,23,1431.1916398788,39,1472.2352171644,10,10,4,-0.779750220046067,39,15,-2.6568140627171
"Gambill J.M.",1477.56391035592,260,1491.22050162191,197,1515.68023145602,33,1386.29153648889,30,1500,0,1427.22565124527,63,1480.26685879075,218,1485.30780278986,42,42,19,-2.07006246136664,218,116,1.1726188756033
"Grosjean S.",1506.93545498544,419,1498.48870313995,258,1607.72018499243,62,1594.37567937548,99,1500,0,1588.03747204979,161,1498.01129385061,312,1623.87540654906,107,107,71,6.73497279672102,312,177,-6.45755459730347
"Henman T.",1616.13581256142,386,1632.75794851689,249,1647.74457275246,60,1596.26492039583,77,1500,0,1625.92615296347,137,1619.50674455668,291,1620.95659657418,95,95,65,2.62626641877765,291,186,2.01916608367931
"Hewitt L.",1598.90193187812,709,1617.91112681344,458,1689.09598011769,133,1610.26513600082,118,1500,0,1636.71694174036,251,1620.44699890684,504,1638.4541255778,205,205,144,5.90601546823421,504,358,-1.94993819310938
"Lisnard J.",1457.30292736868,28,1447.46495235223,12,1500,0,1481.01764784361,16,1500,0,1483.77021223556,16,1455.75340295122,21,1475.40830503871,7,7,2,-0.202616862634579,21,7,-1.50526604261814
"Martin A.",1561.38947321718,408,1382.19972195738,137,1421.23364697986,18,1596.95660029724,253,1500,0,1586.55890752346,271,1547.4992446191,354,1448.23510588777,54,54,20,-2.92857306948206,354,166,5.38415199816914
"Norman M.",1502.82270527821,181,1553.43181198077,106,1500.01671385569,2,1496.46240617735,73,1500,0,1493.54652631164,75,1516.95483090481,152,1545.97530727244,29,29,19,0.734117219444255,152,88,-0.621209008315706
"Petrovic D.",1455.97835918948,8,1473.69739977226,4,1476.69705692732,4,1500,0,1500,0,1478.91805673182,4,1491.33139175684,5,1462.23357955609,3,3,0,-1.52122141428581,5,2,-0.239644218134808
"Sekulov J.",1435.20238485885,12,1456.2878039448,10,1486.63476371345,1,1486.64811173437,1,1500,0,1472.93143534685,2,1433.18390552577,10,1500,2,2,1,0.00349581895410611,10,2,-2.59540042460012
"Stoltenberg J.",1531.96959413885,49,1501.0251942206,32,1511.89564449752,7,1546.26053090058,10,1500,0,1554.98149336545,17,1545.65138340053,39,1481.71779613784,10,10,4,-1.22442702558933,39,24,2.50321079114343
"Vinck C.",1395.92568798816,34,1435.21065856816,16,1499.99648432736,8,1439.34047873717,10,1500,0,1437.57347717096,18,1392.31768894642,27,1488.94240418887,7,7,3,-0.168065804078825,27,7,-3.99490667639486
"Agenor R.",1393.98404245504,26,1450.78502335265,11,1487.5,3,1435.52180833583,12,1500,0,1424.485766117,15,1408.55035537642,22,1476.29961122624,4,4,1,-0.83240513098137,22,6,-3.40823317081685
"Behrend T.",1395.49159556723,104,1401.73406026919,35,1454.38815476486,4,1465.49703017585,65,1500,0,1439.31681331644,69,1411.05016723601,88,1401.34460324871,16,16,2,-3.31287003516593,88,34,-0.867466142144806
"Damm M.",1429.41377490269,41,1440.34077611796,21,1497.39008376095,12,1481.33585300854,8,1500,0,1476.12170739762,20,1459.12426177165,31,1438.77844880974,10,10,2,-1.73355600280018,31,14,-1.08989300109241
"Delgado J.",1398.63284862161,37,1429.83076277244,15,1428.94727401382,21,1490.72763614124,1,1500,0,1437.03287249291,22,1410.13505063717,26,1452.23584986257,11,11,2,-1.00967237082964,26,8,-3.04501368430606
"Golmard J.",1529.45564124825,136,1568.43857874004,86,1454.42540194182,12,1520.39540797287,38,1500,0,1470.21700287132,50,1561.04060903144,114,1474.39873213045,22,22,9,-2.54944551944425,114,65,3.72767116937427
"Hantschk M.",1400.87065614953,58,1424.70072698506,24,1475.03176437078,4,1475.3784244352,30,1500,0,1461.2500697587,34,1416.19230606708,53,1466.09240323868,5,5,1,-1.13824103965764,53,22,-2.82693271436112
"Jonsson F.",1383.44313505116,22,1446.68114081783,13,1475.09264410069,2,1445.73501961563,7,1500,0,1420.56055008535,9,1404.53288684516,18,1473.7028709405,4,4,1,-0.941420843107445,18,4,-3.72085375484606
"Ketola T.",1449.31324133189,16,1468.44502774946,12,1475.37800025815,4,1500,0,1500,0,1473.71990985622,4,1460.21220274663,12,1479.13744541326,4,4,1,-0.612179034794641,12,4,-1.41529131192965
"Manta L.",1422.06439074591,16,1481.0822383559,10,1462.08219715363,3,1464.97533958843,3,1500,0,1427.77973049777,6,1431.85537397915,15,1487.5,1,1,0,-0.517981188372765,15,4,-2.59944318179076
"Paes L.",1433.13813414382,14,1441.28319078828,11,1501.69471715219,2,1487.05047029068,1,1500,0,1486.79734624611,3,1429.36586944403,10,1499.08901917754,4,4,2,0.147834325157459,10,2,-2.82230895940474
"Pioline C.",1526.97629264452,110,1522.57474457801,54,1496.05318680763,15,1543.60600484602,41,1500,0,1522.81921790903,56,1540.19884739902,89,1500.96067027655,21,21,11,-1.15831165799657,89,48,2.23736336377743
"Sanguinetti D.",1471.51422267798,256,1503.77388268888,154,1453.76056343945,40,1433.90573340219,62,1500,0,1425.27040337004,102,1462.75022713688,216,1437.67081955317,40,40,12,-3.74962330074408,216,93,2.61019220786307
"Stanoytchev O.",1369.03107571965,28,1448.22854473991,9,1487.5,1,1417.35184336338,18,1500,0,1405.70681445918,19,1379.74520016794,24,1479.26530005594,4,4,1,-0.657193854844326,24,6,-4.58156311636969
"Tabara M.",1461.85575346984,74,1506.81760030311,40,1475.48415331792,2,1468.05538392323,32,1500,0,1447.03561816862,34,1478.39693808567,57,1445.82955346749,17,17,5,-1.64525670999338,57,26,0.11948684878702
"Vanek J.",1457.65237673276,177,1408.73261251938,58,1445.51436399613,8,1491.97433496459,111,1500,0,1475.13855755071,119,1458.34685212874,148,1376.73148054356,29,29,5,-4.16823219397531,148,61,2.47432726328582
"Vinciguerra A.",1493.17318523391,145,1494.82622637871,83,1465.69699579516,7,1499.15500593481,55,1500,0,1482.49281368086,62,1482.48028244243,119,1491.26364693488,26,26,12,0.0833336621534019,119,56,-0.356406252796836
"Bastl G.",1430.08085944087,101,1450.0531487758,74,1418.92719021599,15,1426.16731479622,12,1500,0,1377.49377193003,27,1431.46798055765,88,1443.84988804151,13,13,3,-1.72144596175696,88,32,-1.07531966060833
"Berasategui A.",1402.61866908179,19,1451.22763354439,6,1488.33419129852,1,1440.80407711489,12,1500,0,1433.70302841969,13,1425.46415135888,16,1463.38290646128,3,3,0,-1.16974644371549,16,4,-2.72550679301311
"Caratti C.",1419.62541086125,12,1436.2183574939,7,1464.82035319984,5,1500,0,1500,0,1465.25474094587,5,1440.04067917015,10,1472.63459479353,2,2,0,-0.834922708193964,10,2,-2.38006085735622
"Cherkasov A.",1486.07494303563,3,1486.635633964,3,1500,0,1500,0,1500,0,1500,0,1486.91399076936,3,1500,0,0,0,0,3,1,-0.557002278574756
"El Aynaoui Y.",1571.79585790015,258,1559.80787166964,125,1526.7055222149,16,1602.77561670639,117,1500,0,1589.47863851649,133,1567.92253236632,207,1591.65346449134,51,51,31,1.87147438037087,207,118,1.00035993563491
"Gaudio G.",1508.93049746108,397,1520.38881536768,115,1471.33896068705,7,1539.64912599108,275,1500,0,1535.80920378122,282,1516.98611832034,327,1575.40124927489,70,70,37,-4.4665690922036,327,199,4.82378899064665
"Kiefer N.",1661.65370713082,366,1696.73033016222,239,1562.88340979578,53,1587.54762044806,74,1500,0,1614.97200415239,127,1652.11313043213,292,1613.22098892107,74,74,42,1.62244224948617,292,164,4.84370603574667
"Marin J.A.",1375.99085914215,81,1424.31661730723,9,1486.61761473855,1,1393.84033527151,71,1500,0,1385.32665118102,72,1392.01205696194,74,1425.86713445588,7,7,0,-2.57047626981402,74,26,-2.38988936450013
"Mirnyi M.",1528.56608087764,353,1512.33212441927,220,1583.61382337564,51,1460.69673019384,82,1500,0,1536.18130874371,133,1511.18203882045,290,1528.98239006235,63,63,30,-1.99808587470637,290,146,3.14072910981186
"Santoro F.",1584.76925961274,385,1551.95263742863,252,1621.21061542112,67,1413.19606767568,66,1500,0,1566.94541648428,133,1581.560428074,306,1538.82527158806,79,79,38,0.664221553934726,306,161,2.72654883057488
"Schalken S.",1570.39750089427,278,1549.50188226987,170,1654.65275759079,48,1548.53701740764,60,1500,0,1620.59299840296,108,1535.72220344163,220,1670.39510641855,58,58,39,6.92232964307092,220,118,-4.10642960730024
"Schuettler R.",1498.8899501962,513,1466.96678995556,313,1573.82644976268,71,1389.12361215214,129,1500,0,1503.32447915789,200,1488.32490202067,424,1465.30726139981,89,89,43,0.702134935665139,424,211,-0.746536927817195
"Squillari F.",1553.04096000234,189,1506.17011834644,52,1451.71633544716,4,1541.13402260028,133,1500,0,1531.44700636539,137,1555.70946568192,161,1487.99098334946,28,28,14,0.133528703771034,161,81,1.98810969632244
"Tillstrom M.",1495.98599244229,31,1511.45667438625,21,1474.55047029068,2,1507.01925243521,8,1500,0,1481.07119900592,10,1525.13386022284,26,1462.87220844559,5,5,1,-1.50941824263873,26,14,1.3488579403302
"Vacek D.",1388.86604982026,29,1420.84542558478,23,1482.89498086892,2,1452.46239729828,4,1500,0,1436.44559352535,6,1393.94620104396,24,1472.10712029418,5,5,1,-0.496342248179237,24,5,-3.9490157590104
"van Lottum J.",1402.19766374322,65,1406.90748885845,31,1462.19307395759,12,1461.67993357107,22,1500,0,1434.95277682202,34,1418.98319769702,50,1425.88847067921,15,15,3,-1.9017480534833,50,16,-2.0103453967881
"Balcells J.",1457.8570868278,77,1471.00775584022,35,1464.32167426039,3,1523.88057726771,39,1500,0,1489.0472578063,42,1496.437253779,66,1424.77197861825,11,11,2,-2.85352050328584,66,33,1.16780397639793
"Chang M.",1461.09173920823,137,1457.67944404808,95,1512.33475586707,17,1477.66533861751,25,1500,0,1475.69108325705,42,1476.81262647919,115,1446.59111567357,22,22,8,-2.55568090344369,115,57,0.999350471772773
"Ferrero J.C.",1672.53513318371,655,1633.23425975728,301,1621.61577053399,47,1691.64292850645,307,1500,0,1682.36238649734,354,1665.16379404972,502,1636.76486443224,153,153,103,3.31181601966991,502,322,3.58958930767859
"Gustafsson M.",1536.59546314761,61,1497.31927474973,18,1505.66774714701,12,1554.71066322527,31,1500,0,1550.2816663881,43,1553.9505922159,52,1470.50482712207,9,9,3,-0.930000198018744,52,29,2.39381872392332
"Haas T.",1668.46545297283,631,1666.76847741741,417,1661.36995176339,66,1701.06842109355,148,1500,0,1711.44391393938,214,1682.85611255202,494,1663.57620627391,137,137,89,2.5346548950767,494,316,4.2039632238366
"Johansson T.",1586.13667028933,338,1589.73817605718,229,1568.05602561946,55,1467.61590043248,54,1500,0,1505.31437092845,109,1593.20135232628,264,1564.30967589689,74,74,45,5.92063494759537,264,136,-2.47516813602227
"Novak J.",1626.37600333196,326,1661.74918747893,175,1520.08532609071,27,1589.76517208469,124,1500,0,1568.85192581633,151,1589.82223168283,260,1609.90441192287,66,66,41,1.76683884830605,260,154,3.28820128497229
"Rosset M.",1468.33892520758,111,1489.21767676647,54,1483.97609543228,18,1455.6452407988,39,1500,0,1457.91482191511,57,1484.32947467348,90,1449.74233062164,21,21,8,-1.24885738364459,90,40,-0.0175856080520891
"Sell M.",1500.84942080171,2,1500.84942080171,2,1500,0,1500,0,1500,0,1500,0,1500.84942080171,2,1500,0,0,0,0,2,1,0.0339768320685254
"Arazi H.",1550.11707864718,194,1557.78597330988,105,1541.51724482312,23,1441.65341651867,66,1500,0,1480.94991976331,89,1505.11363331837,145,1571.09358955194,49,49,28,5.21341519277021,145,67,-3.2087320468832
"Clavet F.",1460.28077008833,144,1509.77745847034,77,1490.68542363715,7,1412.82267527403,60,1500,0,1400.1677027812,67,1476.10183351708,124,1441.57242922192,20,20,7,-1.96678818491506,124,57,0.37801898844801
"Clement A.",1538.33958300355,450,1516.52251509262,290,1526.42156020178,80,1472.07346199085,80,1500,0,1501.72767875943,160,1528.17169456372,351,1505.99675692233,99,99,54,5.18175051294487,351,169,-3.64816719280282
"Corretja A.",1484.20021994637,228,1546.05775500944,108,1477.5646806819,2,1503.83975783356,118,1500,0,1491.98272650654,120,1480.49679356758,183,1586.20170439794,45,45,30,3.9724533037058,183,105,-4.60444450585109
"Hrbaty D.",1484.66026383398,407,1521.68129963424,263,1443.36010844797,20,1497.99806049548,124,1500,0,1461.48751908299,144,1501.94444134512,327,1522.16354071823,80,80,43,2.21758447023986,327,166,-2.83117391688052
"Ilie A.",1394.15427176991,101,1400.45550303195,56,1435.56371074905,6,1513.1026073063,39,1500,0,1464.91057180999,45,1415.2908750749,83,1460.43636127936,18,18,7,-0.413935238162415,83,33,-3.81989389104134
"Koubek S.",1536.97431295863,338,1557.48477172701,190,1415.35564610304,26,1478.74611893291,122,1500,0,1449.37871711778,148,1503.05279061928,276,1510.36167619063,62,62,28,0.539738963216336,276,120,0.939233555128886
"Kucera K.",1556.58343706418,159,1583.42978106594,98,1523.35932067077,26,1418.02629974939,35,1500,0,1470.14722900314,61,1528.19301381453,125,1532.44413970207,34,34,16,0.4319376491476,125,64,1.83139983341975
"Lapentti N.",1500.94486205239,341,1500.57617915226,141,1482.9481169844,18,1525.68268324053,182,1500,0,1493.91724191062,200,1538.6931031673,279,1466.78238881127,62,62,31,-1.88252748003445,279,138,1.92032196212997
"Ljubicic I.",1669.29923726641,577,1637.13165370627,372,1532.94991343896,50,1686.78547275428,155,1500,0,1672.90694748052,205,1660.40442474079,479,1589.17576017098,98,98,49,-11.2860441595306,479,292,18.0580136501872
"Martin T.",1578.84001455757,138,1578.58985503306,88,1565.58756701624,22,1481.03693254102,28,1500,0,1545.90896467659,50,1560.01415948072,91,1587.7933365466,47,47,28,4.26776641254318,91,48,-1.11416583024027
"Voinea A.",1441.76330010802,112,1486.74502122564,53,1469.90120149317,11,1438.10106249414,48,1500,0,1421.40365954652,59,1435.55529806817,90,1481.70698811767,22,22,10,0.801650125827566,90,35,-3.13111812150685
"Agassi A.",1809.67494367141,343,1820.7034917839,256,1596.98061771682,29,1664.4188993096,58,1500,0,1668.99731576855,87,1788.18579578848,230,1788.59637489574,113,113,91,10.537225201056,230,170,1.84977254580053
"Alami K.",1389.20186878619,73,1397.35581182413,32,1488.75452877921,5,1453.65309855956,36,1500,0,1445.87569820721,41,1384.22423564385,61,1480.63359184256,12,12,5,0.0841210620139895,61,22,-4.5160463105663
"Bjorkman J.",1559.5121365979,330,1497.3038972317,211,1627.5739412886,76,1434.17144619322,43,1500,0,1589.18170015456,119,1541.51605016232,256,1566.30565360958,74,74,41,5.85668719291583,256,121,-3.47620172899973
"Black W.",1472.18694821239,37,1459.73569944937,31,1479.59472656616,6,1500,0,1500,0,1485.50980462469,6,1461.01059874422,28,1491.53772703423,9,9,4,0.279347795822202,28,10,-1.39186986732645
"Dupuis A.",1516.13440411779,180,1424.87001778143,84,1536.24030483014,39,1434.70615255946,57,1500,0,1509.82752377776,96,1533.21482171524,152,1407.074926452,28,28,8,-2.00056943658283,152,63,2.64594560129448
"Ferreira W.",1601.59264400546,200,1576.67821031725,134,1560.30897321715,29,1526.87459840637,37,1500,0,1561.21254535746,66,1584.90639596003,147,1588.33170312338,53,53,33,3.82918167435503,147,81,0.2345240858632
"Hill M.",1487.94433938657,3,1500.06196425891,2,1487.94952970932,1,1500,0,1500,0,1487.93337675196,1,1487.89934909509,1,1500,2,2,1,0.00247857035630217,1,0,-0.484704994893431
"Ivanisevic G.",1499.85413218339,101,1488.19319978167,72,1571.82888965054,19,1398.61012964885,10,1500,0,1505.98024347232,29,1428.2077525598,81,1581.57367008785,20,20,13,4.67242865417394,81,31,-4.67826336683843
"Kafelnikov Y.",1626.07334354774,253,1614.36528297151,172,1581.7403730515,23,1595.64576052053,58,1500,0,1605.65086302924,81,1626.22425829903,199,1601.89689693144,54,54,37,4.71124858202512,199,121,0.33168515988458
"Krajicek R.",1607.35154335004,69,1541.41693919206,37,1553.16299469668,19,1534.38429771487,13,1500,0,1576.16603360487,32,1577.38617293644,49,1568.17778617877,20,20,13,2.49202642402708,49,27,1.80203530997459
"Kroslak J.",1448.19128147953,17,1468.83463870651,13,1500,0,1475.82692918846,4,1500,0,1475.7900210384,4,1449.86639661099,15,1500,2,2,1,0.00257247591936571,15,5,-2.07492121673806
"Llodra M.",1623.26673563549,368,1607.89898761962,238,1607.88737538313,73,1493.63251177362,57,1500,0,1595.58966223441,130,1640.09747927789,283,1502.93223796179,85,85,34,-3.63752453885322,283,138,8.56819396427286
"Philippoussis M.",1631.02881698773,209,1503.74827569663,138,1663.95119877877,45,1497.85318051938,26,1500,0,1677.8949576911,71,1618.7474371181,153,1591.41899089978,56,56,35,5.71176960442365,153,85,-0.470616924914461
"Portas A.",1454.54097969311,215,1382.30328250117,32,1436.4941550296,12,1472.4098254114,171,1500,0,1452.80763180619,183,1470.08255690166,183,1427.8279923631,32,32,12,-2.0126213052378,183,76,0.194260492962398
"Pozzi G.",1404.70530523869,71,1441.12713465783,42,1512.00488200013,19,1436.52425876709,10,1500,0,1454.65289294427,29,1423.99414273329,57,1475.49906526423,14,14,6,-0.925735044193743,57,24,-2.88605274625884
"Pretzsch A.",1441.38637698957,21,1460.77848190483,17,1470.42585525583,3,1486.42351207674,1,1500,0,1456.01653060325,4,1443.35917767949,18,1488.81742227746,3,3,1,-0.25508247320927,18,5,-2.08946244720795
"Rochus C.",1382.27010209968,303,1394.69325516299,128,1342.72911361483,25,1451.60965279482,150,1500,0,1398.63558557677,175,1392.12984841156,254,1377.66715619455,49,49,15,-3.19750013193757,254,93,-1.51169578407522
"Sampras P.",1757.85415270705,137,1777.5313791612,98,1621.47046583404,24,1477.10734841255,15,1500,0,1568.02724737811,39,1654.05385372371,83,1733.6944539063,54,54,43,8.80714896372029,83,55,1.50701714456166
"Sluiter R.",1520.3120401136,188,1457.30135700496,80,1526.46152946434,45,1494.24109045187,63,1500,0,1520.29721132182,108,1506.5151027652,151,1451.94536265775,37,37,12,-2.69907615266958,151,68,3.51155775721361
"Srichaphan P.",1549.9031506191,355,1570.83469845268,276,1545.49357535257,39,1349.52728406769,40,1500,0,1435.84993232348,79,1566.35641978348,303,1500.85316417349,52,52,24,-2.55639480140288,303,167,4.55252082616696
"Stafford G.",1499.55219348043,2,1499.55219348043,2,1500,0,1500,0,1500,0,1500,0,1500,0,1500,2,2,1,-0.0179122607828529,0,0,0
"Tieleman L.",1446.06441673667,28,1494.50345137248,17,1465.09839119602,5,1455.72410694837,6,1500,0,1425.05963690615,11,1450.36277336447,25,1487.45935069303,3,3,1,-0.262266682117881,25,9,-1.8951566484152
"Ullyett K.",1462.29670145983,7,1461.45495234338,7,1500,0,1500,0,1500,0,1500,0,1462.81658625921,5,1500,2,2,1,0.0185807277373358,5,1,-1.5267126693443
"Vicente F.",1357.29990596571,240,1438.30526777408,83,1449.47453800804,15,1407.3968265314,142,1500,0,1388.119582683,157,1372.27496840611,198,1459.52642905845,42,42,18,0.691039321313778,198,81,-6.39904308268545
"Woodbridge T.",1466.46571201008,20,1443.14208754419,11,1512.76366205911,7,1499.55271256477,2,1500,0,1511.75371615657,9,1474.73931548369,13,1485.55625498158,7,7,3,-0.432972715258266,13,5,-0.90839880433844
"Woodforde M.",1462.99433420696,10,1468.21621345414,9,1487.5,1,1500,0,1500,0,1493.03931360787,1,1465.07128526565,7,1491.24787646698,3,3,1,-0.122891627806786,7,2,-1.35733500391465
"Woodruff C.",1454.83282815892,67,1491.35062194715,51,1481.51202653305,6,1430.19998339326,10,1500,0,1426.846267552,16,1432.81169513175,50,1516.2606547095,17,17,9,2.08655689763026,50,19,-3.89324377127362
"Zabaleta M.",1536.24461473393,292,1455.09604965717,102,1445.18944161515,5,1594.18061797969,185,1500,0,1578.09991657379,190,1599.5773376025,250,1435.92024622369,42,42,17,-2.73929849996225,250,127,4.18908308931942
"Blanco G.",1436.18191966543,145,1397.25116247853,25,1452.97829485925,4,1472.65786176654,116,1500,0,1452.76499897187,120,1419.99460090681,121,1487.20041592337,24,24,9,-0.0537635740666225,121,49,-2.49895963931605
"Costa A.",1554.00966961325,256,1512.48641385237,104,1486.59033155939,1,1575.57603112818,151,1500,0,1568.99019421184,152,1559.04075149385,206,1581.15209349184,50,50,31,3.63224496755362,206,107,-1.47185818302365
"Mantilla F.",1562.88339537491,231,1508.98166937228,73,1463.01734052681,7,1600.55822091469,151,1500,0,1575.20017315178,158,1572.24965279513,199,1469.31493258111,32,32,12,-4.569151791361,199,109,7.08448760635728
"Pavel A.",1479.92029520237,331,1449.4405589802,166,1472.54035121595,35,1556.05101763741,130,1500,0,1515.21044929197,165,1507.2350586082,272,1492.5624520833,59,59,29,-1.65124465234993,272,139,0.848056460444764
"Diaz J.",1370.44444814702,43,1392.62715903344,18,1487.93810396903,1,1433.36421155344,24,1500,0,1423.1178298988,25,1392.63159957677,33,1439.08316197737,10,10,2,-1.48061975575472,33,8,-3.70160231836465
"Guardiola T.",1460.23026829338,8,1503.74992284716,4,1500,0,1453.56483246912,4,1500,0,1452.80833983983,4,1472.61950747853,6,1478.3988148222,2,2,0,-0.454108913875407,6,2,-1.1366803543892
"Roux L.",1478.87308317824,13,1476.8011863168,13,1500,0,1500,0,1500,0,1500,0,1476.60209953887,13,1500,0,0,0,0,13,5,-0.845076672870446
"Siemerink J.",1420.77062930548,52,1461.7593757447,23,1459.87158128212,10,1462.79128206958,19,1500,0,1426.65729094157,29,1435.23974554871,43,1452.07655956736,9,9,2,-1.41904892978252,43,17,-1.75012589799826
"Courier J.",1490.9139660001,9,1491.2979876858,9,1500,0,1500,0,1500,0,1500,0,1500.52340321859,8,1487.5,1,1,0,-0.483309436881818,8,4,0.119868076885636
"Gimelstob J.",1444.57090857708,150,1424.26408429814,97,1512.67613881086,40,1423.17869094018,13,1500,0,1468.98949345114,53,1439.66758551854,119,1448.76321027528,31,31,11,0.824028128017742,119,45,-3.04119178493464
"Goldstein P.",1517.51357704199,160,1527.31249657605,117,1493.49836764273,17,1484.20556893,26,1500,0,1475.2739166141,43,1534.48081346585,138,1444.90379158617,22,22,7,-1.96786758957423,138,63,2.66841067125363
"Gumy H.",1437.40228193594,31,1469.36019695372,9,1487.96400122406,1,1456.00417938915,21,1500,0,1446.50215662171,22,1440.20753047409,25,1479.16558822975,6,6,2,-0.287089832344035,25,9,-2.21681889021853
"Larsson M.",1535.49666755009,57,1558.62730237036,35,1499.34093574909,12,1487.84909293593,10,1500,0,1483.43345186772,22,1541.00068921023,48,1499.36113164627,9,9,4,-0.329571030101854,48,27,1.74943773210562
"Liukko V.",1498.92974983855,4,1498.92974983855,4,1500,0,1500,0,1500,0,1500,0,1497.84869771671,4,1500,0,0,0,0,4,2,-0.0428100064579092
"Malisse X.",1564.39312645951,483,1523.02288287646,313,1662.49731069737,79,1461.18533744738,91,1500,0,1603.1043652447,170,1564.45407028392,382,1537.71982168801,101,101,55,5.79572617740211,382,192,-3.22000111902164
"Mamiit C.",1392.02953510191,95,1414.71171526151,74,1437.46129366069,12,1449.4392439364,9,1500,0,1398.25631745009,21,1398.97178686488,81,1431.31370281318,14,14,3,-1.97955206480549,81,27,-2.33926653111795
"Sargsian S.",1486.45694782651,200,1495.19902342871,106,1437.30269774298,30,1495.03992297399,64,1500,0,1455.95334184354,94,1457.37263101004,156,1524.74601553928,44,44,22,4.8384817360906,156,60,-5.38020382303035
"Zib T.",1426.53137612871,119,1399.4392339444,57,1470.47863051391,16,1419.67558774692,46,1500,0,1437.0779493084,62,1412.53730060683,101,1436.19478199326,18,18,4,-0.584433613943722,101,32,-2.35431134090801
"Levy H.",1353.40382672956,114,1373.67127238054,68,1461.37772523438,16,1423.5534273728,30,1500,0,1407.79919960171,46,1370.36401837348,97,1415.95729849536,17,17,4,-2.62112089216964,97,34,-3.24272603864813
"MacPhie B.",1502.45802055879,2,1502.45802055879,2,1500,0,1500,0,1500,0,1500,0,1502.23343674415,2,1500,0,0,0,0,2,1,0.0983208223517998
"Massu N.",1459.80581888346,414,1495.36685182094,153,1452.15071455499,17,1482.09774291924,244,1500,0,1463.47428732817,261,1488.36780867854,354,1438.49586010516,60,60,23,-5.57960638480613,354,187,3.97183914014447
"Popp A.",1476.4279097131,106,1428.13622832511,41,1573.19996400154,38,1363.01829967509,27,1500,0,1492.08488804563,65,1456.12647955286,73,1494.81314699838,33,33,16,2.87951436051639,73,28,-3.82239797199246
"Reneberg R.",1501.07533270558,2,1501.07533270558,2,1500,0,1500,0,1500,0,1500,0,1501.32739812423,2,1500,0,0,0,0,2,1,0.0430133082230404
"Rodriguez M.",1446.16325028458,15,1474.99803105724,4,1500,0,1465.87309147008,11,1500,0,1464.73180993187,11,1465.00128649911,13,1475.44952970932,2,2,0,-1.00581288471549,13,5,-1.14765710390133
"Sa A.",1394.46810404321,115,1431.98101219351,58,1475.25196387924,22,1378.55882750089,35,1500,0,1397.47846035814,57,1389.3485496473,93,1466.85859241153,22,22,8,0.161889891653821,93,33,-4.38316572992534
"Salzenstein J.",1423.85635471507,37,1426.09304840233,26,1483.11658381088,7,1486.40816618955,4,1500,0,1468.10423931226,11,1443.16157562095,33,1452.15874002819,4,4,0,-1.54983334157678,33,11,-1.49591246982024
"Black B.",1499.80433229239,73,1466.36052834073,48,1568.22360994058,19,1453.45183625691,6,1500,0,1553.58958736329,25,1497.93185687029,58,1491.28082589745,15,15,7,-0.232181437961925,58,28,0.224354729657448
"Dewulf F.",1476.79914190001,4,1489.22849795456,3,1500,0,1487.13077879029,1,1500,0,1487.13077879029,1,1476.44728737695,4,1500,0,0,0,0,4,1,-0.928034323999599
"Rusedski G.",1580.52459209277,245,1584.60027432912,161,1650.56129090377,58,1427.64350077188,26,1500,0,1587.04291835756,84,1614.96456886534,200,1473.30223508899,45,45,21,-4.33562450403913,200,117,7.55660818774994
"Wessels P.",1518.66211831301,66,1439.23994484545,36,1567.17208421272,23,1474.69809479088,7,1500,0,1551.98057802932,30,1517.22872905347,55,1463.38611670686,11,11,3,-1.30674388955971,55,27,2.05322862208002
"Saulnier C.",1494.09141187157,160,1509.45570783077,116,1456.19216318702,24,1430.13226689231,20,1500,0,1419.5156811003,44,1493.49629359749,134,1411.18639487365,26,26,6,-2.1824617170707,134,55,1.94611819193357
"Tarango J.",1351.96006861192,43,1348.29915124465,22,1477.58193262568,4,1484.57543021503,17,1500,0,1463.18219093422,21,1369.99236281019,37,1455.7870665851,6,6,1,-1.29396887786632,37,10,-4.62762837765672
"Canas G.",1571.22494439744,345,1624.34263643344,145,1574.70032368423,35,1616.01112510402,165,1500,0,1602.9943126606,200,1590.36399461939,277,1557.6614011046,68,68,37,-1.91968666101833,277,174,4.76868443691584
"Chela J.I.",1516.85738314837,553,1496.5618232636,233,1431.2820609021,15,1586.52931020426,305,1500,0,1563.60598140644,320,1513.06963948707,464,1540.83222083899,89,89,46,-3.19695712543606,464,254,3.87125245137077
"Hernandez A.",1457.5746282235,6,1500,0,1500,0,1462.08002315614,6,1500,0,1460.52931075496,6,1459.78066935578,6,1500,0,0,0,0,6,1,-1.69701487106006
"Kuerten G.",1493.37681323036,286,1571.72602165016,138,1513.46454842073,5,1572.36965249776,143,1500,0,1566.82289358248,148,1501.84165247006,222,1606.42038188614,64,64,43,-0.580500251126488,222,150,0.315572780341054
"Meligeni F.",1547.94286751469,121,1517.61134447128,42,1474.22995317832,4,1524.20145282953,75,1500,0,1516.24171980377,79,1542.36496650517,102,1468.76449393555,19,19,7,-0.235237238288599,102,49,2.1529519388762
"Puerta M.",1611.6975578049,156,1473.88660289814,29,1461.75359245119,3,1649.15099362241,124,1500,0,1624.56654383832,127,1587.6418849547,132,1515.83183157498,24,24,12,0.506790798393421,132,71,3.96111151380253
"Heuberger I.",1404.81449405055,67,1425.44698637341,47,1465.21278679611,8,1426.62700799958,12,1500,0,1411.48432526046,20,1403.54823509942,54,1446.46249097131,13,13,3,-0.763083008082603,54,17,-3.04433722989541
"Safin M.",1653.23678476882,478,1628.55993923655,295,1626.90695551888,42,1587.84890184714,141,1500,0,1616.72534978523,183,1631.73516070243,358,1687.7690324869,120,120,85,12.6789775933019,358,212,-6.54950620254911
"Bryan M.",1484.56921506499,13,1500.30065400151,9,1479.3019433043,4,1500,0,1500,0,1476.67314574586,4,1489.71936980863,12,1494.29246740191,1,1,0,-0.149951487478721,12,5,-0.467279909921555
"Calatrava A.",1404.6708972381,132,1429.30672847647,50,1465.82269961168,5,1433.34903739292,77,1500,0,1428.78371312042,82,1396.27607444108,114,1472.1245341039,18,18,7,0.0848986607886565,114,47,-3.89806277126476
"Hipfl M.",1428.4290869866,90,1434.8557998572,17,1454.04130839282,6,1466.69115369466,67,1500,0,1439.20324996524,73,1447.98452111125,78,1420.34999275381,12,12,2,-3.61104711148167,78,34,0.748210590945516
"Rafter P.",1771.60745168997,96,1721.3505808602,65,1648.24147193818,26,1466.16882236783,5,1500,0,1626.68170726638,31,1728.03416327172,68,1644.1274491906,28,28,21,3.80400378097735,68,46,7.06029428662119
"Alvarez E.",1432.25551173771,20,1449.95738272428,4,1500,0,1475.83960745286,16,1500,0,1473.41578074879,16,1439.61083463794,19,1489.18457842916,1,1,0,-0.265775396060822,19,7,-2.44400413443084
"Calleri A.",1520.00959870894,359,1519.39112483585,136,1447.72005485766,14,1573.02056438118,209,1500,0,1545.72808549147,223,1543.86671568587,308,1422.50965921265,51,51,18,-8.10133094476093,308,171,8.9017148931184
"Garcia A.",1380.93481288665,34,1434.26270230464,11,1479.3114569937,2,1448.05983146845,21,1500,0,1424.50071573134,23,1386.5054264583,33,1486.66726264087,1,1,0,-0.50577352373006,33,9,-4.25683396080411
"Hood M.",1487.3189532633,5,1500,0,1500,0,1488.82661910907,5,1500,0,1487.2161374097,5,1487.56119556294,5,1500,0,0,0,0,5,2,-0.507241869467967
"Ulihrach B.",1459.83042406618,175,1536.9927779184,89,1447.12378914504,10,1442.2471102367,76,1500,0,1411.64940626178,86,1464.07035120514,149,1426.63955511828,26,26,7,-4.00292768639839,149,72,2.39614464904549
"di Pasquale A.",1426.61460554848,83,1432.31313614929,26,1500,2,1428.2238301546,55,1500,0,1424.98323420641,57,1410.51137903101,69,1477.38054574399,14,14,5,0.479725755682053,69,23,-3.41514153374278
"Etlis G.",1486.09959315768,30,1502.53686159712,7,1500,0,1457.31418014872,23,1500,0,1462.54584193895,23,1473.62492214509,28,1504.86926065513,2,2,1,0.47350566037692,28,10,-1.02952193406958
"Prieto S.",1452.17730886529,6,1500,0,1500,0,1458.81194986587,6,1500,0,1457.52172564107,6,1452.86409319165,6,1500,0,0,0,0,6,1,-1.91290764538849
"Moya C.",1587.30489610354,549,1606.62971870275,250,1496.18418715218,12,1620.47613599644,287,1500,0,1618.73168693222,299,1615.4178154796,464,1576.64648194961,85,85,51,-5.4910335462501,464,306,8.98322939039157
"Rios M.",1729.44114170334,158,1728.09498602507,102,1500,0,1602.22284165469,56,1500,0,1596.54480184254,56,1744.26326688618,138,1526.06081830338,20,20,11,-0.176590389038811,138,89,9.35423605717238
"Arthurs W.",1543.71915278495,235,1527.93109493265,142,1515.27672680585,49,1445.70919939172,44,1500,0,1483.09447504442,93,1538.30738898594,186,1459.08197040445,49,49,20,-0.177215159240544,186,82,1.92598127063856
"Fish M.",1738.01620117863,482,1704.88624265966,358,1685.98236348108,72,1532.02448834441,52,1500,0,1677.31973503003,124,1716.95007267644,392,1690.12063855051,90,90,52,-1.40818027148511,392,231,10.9288283186305
"Kratochvil M.",1486.32939774336,148,1491.53696013094,82,1512.10226478932,21,1480.94364909514,45,1500,0,1489.47441296657,66,1481.08359604344,125,1485.45479538441,23,23,10,-0.45029471088251,125,57,-0.0965293793832122
"Medvedev A.",1498.14470740257,59,1470.19560059969,18,1475.9970540356,4,1528.23632006494,37,1500,0,1504.73691321397,41,1515.63292484726,49,1477.03395081526,10,10,4,-1.10720677280252,49,24,1.0329950689054
"Roddick A.",1828.47108452825,733,1794.58987468812,536,1781.71882749373,102,1625.77375054487,95,1500,0,1777.36421996646,197,1818.15095462698,556,1761.15727777707,177,177,132,0.574732556845224,556,417,12.5641108242847
"Alonso J.",1457.35187948085,13,1450.02165411732,4,1500,0,1494.56608486708,9,1500,0,1493.29231352881,9,1468.42599846263,12,1487.5,1,1,0,-0.517288700387528,12,4,-1.1886361203786
"Huet S.",1411.3566968367,24,1428.77781289774,9,1490.93661414021,5,1460.75481283887,10,1500,0,1458.996354097,15,1416.76063871602,17,1469.32662065045,7,7,2,-0.596827894172114,17,4,-2.94890423235998
"Bruguera S.",1464.09753382197,70,1455.2076455944,10,1486.61928929314,1,1509.28162133269,59,1500,0,1495.13407070525,60,1493.89284301409,64,1451.46640454772,6,6,1,-2.46004800072788,64,31,1.02394935360667
"Coutelot N.",1486.69186937168,32,1483.86789020398,2,1475.26401998934,2,1505.61847724755,28,1500,0,1486.05628613932,30,1456.51611265579,22,1516.73132517509,10,10,5,1.40259332235928,22,8,-1.93491854749226
"Lopez-Moron A.",1413.8669942683,10,1475,2,1500,0,1435.60435189135,8,1500,0,1435.31211785025,8,1425.36861662883,9,1487.5,1,1,0,-0.5,9,1,-2.94532022926782
"Willems R.",1500.90466303186,2,1500,0,1500,0,1500,2,1500,0,1500,2,1500.55231072213,2,1500,0,0,0,0,2,1,0.0361865212744723
"Wiltschnig H.",1473.07742301443,4,1500,0,1500,0,1475.60027306286,4,1500,0,1474.89446688486,4,1472.72216601668,4,1500,0,0,0,0,4,1,-1.07690307942269
"Boutter J.",1495.79196920625,118,1448.39267168278,54,1421.84913090261,9,1538.16395667919,55,1500,0,1500.17087348281,64,1549.50790059851,97,1406.22162614853,21,21,4,-4.30013887841411,97,46,4.13181764666409
"Ruud C.",1461.28774267979,30,1467.86943659641,6,1475.46338095484,2,1484.26511449524,22,1500,0,1473.13228122639,24,1491.80580592173,26,1453.17927000896,4,4,0,-1.77735316700352,26,11,0.22886287419532
"Navarro S.",1498.50666232094,5,1500,0,1500,0,1496.73607462047,5,1500,0,1496.52454666567,5,1496.191883332,5,1500,0,0,0,0,5,2,-0.0597335071622784
"Coria G.",1534.61482876623,312,1638.20174514977,114,1540.19991179466,16,1601.72431974574,182,1500,0,1577.02076263233,198,1543.25964561953,244,1642.11082806193,68,68,44,-0.720519104917578,244,160,2.10511225556689
"Browne F.",1458.26364801264,28,1478.48120013871,6,1500,0,1466.09907058469,22,1500,0,1463.0463847487,22,1450.7305556776,24,1499.47937066022,4,4,2,0.379106411811318,24,9,-2.04856049130561
"Delgado R.",1471.3668653452,83,1471.19290207288,61,1460.00256132686,6,1492.12634655112,16,1500,0,1455.33125083339,22,1469.04588369876,68,1482.16823684852,15,15,6,0.963270478642011,68,26,-2.10859586483396
"Gonzalez F.",1685.0170750766,487,1683.38217689277,245,1600.3018782279,35,1752.70067564275,207,1500,0,1732.03434487941,242,1689.34098599314,371,1699.06184580974,116,116,74,1.40245237109445,371,235,5.99823063196946
"Russell M.",1502.95900206351,223,1525.75723842047,143,1431.62313955692,33,1386.03301773869,47,1500,0,1395.63670316659,80,1550.82211334598,183,1358.53956662079,40,40,7,-4.74757431651887,183,70,4.86593439905922
"Sabau R.",1403.6974386093,42,1456.75809928159,7,1463.45311161096,5,1431.83790148929,30,1500,0,1412.12643724223,35,1421.31834334769,38,1462.32028972525,4,4,0,-0.964496311111855,38,13,-2.88760614451634
"Kohlmann M.",1464.59095153142,41,1429.35431147882,16,1470.90211158614,9,1515.37647053195,16,1500,0,1504.67130166046,25,1466.82278865936,38,1471.43042714711,3,3,0,-0.79556003134866,38,14,-0.620801907394588
"Gaudenzi A.",1432.05761034349,99,1379.89522293312,37,1475.44842793373,2,1496.2802057753,60,1500,0,1484.6483493415,62,1441.17570620804,83,1448.13000536222,16,16,5,-1.93345920346702,83,32,-0.78423638279343
"Charpentier M.",1448.50654291018,7,1500,0,1500,0,1448.25755164347,7,1500,0,1446.74101204464,7,1442.98602152998,5,1499.79140148266,2,2,1,0.244358264927972,5,0,-2.30409654852066
"Eschauer W.",1386.96034998718,51,1410.60535863287,12,1490.64827968096,3,1447.81320861742,36,1500,0,1447.10941947424,39,1389.28057209349,41,1468.90638283638,10,10,3,-0.429371695897748,41,12,-4.09221430461507
"Savolt A.",1448.66181196818,72,1416.86369188747,23,1473.23621322603,2,1488.95678688933,47,1500,0,1477.12140257599,49,1443.0951864917,59,1475.61588933149,13,13,5,-0.3209919355749,59,23,-1.73253558569797
"Burrieza O.",1469.68269207869,5,1500,0,1487.05047029068,3,1476.53957173515,2,1500,0,1465.76663922169,5,1467.96105549404,5,1500,0,0,0,0,5,1,-1.21269231685243
"Prinosil D.",1423.13919697001,66,1409.29109786144,38,1531.77888293976,21,1422.39852801877,7,1500,0,1485.49462794714,28,1411.3219093073,51,1494.29900912657,15,15,7,0.379159822468003,51,17,-3.45359194366755
"Bryan B.",1449.71321154909,39,1445.00906682435,21,1518.89567005005,14,1459.81541201295,4,1500,0,1481.08282268405,18,1447.31816518458,35,1480.74293084655,4,4,1,-0.243225239801533,35,12,-1.76824629823466
"Knippschild J.",1429.49047972621,42,1428.53736482077,10,1518.38278796059,10,1447.984140916,22,1500,0,1454.48517106543,32,1422.04383538251,33,1477.23882386685,9,9,3,-0.162496136833195,33,11,-2.65788467411856
"Nestor D.",1447.52950429112,25,1447.58278106624,15,1478.80212385948,10,1500,0,1500,0,1482.28689333527,10,1419.13334110522,16,1516.80276576005,9,9,5,1.30380969447186,16,3,-3.40262952282694
"Parmar A.",1458.39555025307,36,1466.83334873739,11,1456.82768897743,25,1500,0,1500,0,1454.42212742672,25,1476.53034293054,28,1462.81975854256,8,8,2,-1.3094940223567,28,11,-0.354683967520575
"Wheaton D.",1483.37208288301,4,1476.81992904684,2,1499.55047029068,2,1500,0,1500,0,1501.77623486336,2,1482.91839130946,4,1500,0,0,0,0,4,1,-0.665116684679472
"Cowan B.",1448.43215675555,16,1463.89063229949,7,1472.08201007153,9,1500,0,1500,0,1473.27887751605,9,1455.06167852191,10,1483.16456787564,6,6,2,-0.371871460013451,10,3,-1.69084226976473
"Braasch K.",1516.90110419895,3,1500,0,1514.12251002442,3,1500,0,1500,0,1516.94147344351,3,1517.80189846726,3,1500,0,0,0,0,3,2,0.676044167958072
"Youzhny M.",1605.37839551979,747,1613.3952757873,414,1620.63748760205,97,1511.36205766124,236,1500,0,1543.32504754255,333,1580.0236649522,588,1633.05328194824,159,159,99,10.1230140584203,588,316,-5.90787823762878
"Bower J.",1495.9101512059,3,1500,0,1487.19300534187,3,1500,0,1500,0,1493.62574379905,3,1500,0,1489.25180971144,3,3,1,-0.163593951764032,0,0,0
"Godwin N.",1430.33646505866,28,1400.84671122656,13,1506.16266110388,15,1500,0,1500,0,1519.42158083019,15,1431.2157930837,23,1494.28569430522,5,5,2,-0.0164688081922094,23,8,-2.77007258946125
"Lareau S.",1445.56850157066,26,1460.69626764664,19,1488.86716952564,5,1474.13046844236,2,1500,0,1466.44382089504,7,1457.22143181751,22,1477.95562030269,4,4,1,-0.783409311939252,22,8,-1.39385062523422
"Lee M.",1414.56188442001,46,1421.84884094178,16,1482.80585242359,25,1465.71954970954,5,1500,0,1456.82063466952,30,1429.07590235593,35,1455.16192522445,11,11,3,-0.860611485884713,35,12,-2.55691313731509
"O'Brien A.",1457.92680499921,10,1450.80092695072,8,1501.14695515403,2,1500,0,1500,0,1499.84784416853,2,1476.21675577321,6,1475.54415415539,4,4,1,-0.876016986039012,6,2,-0.806910813992472
"Rochus O.",1525.93661381063,448,1554.20478634688,230,1545.19106124093,80,1425.83637607704,138,1500,0,1490.87663393536,218,1550.07833228824,365,1435.69494805288,83,83,35,-3.76328293342765,365,173,4.8007474858528
"Spadea V.",1450.5098410783,346,1459.34645913617,235,1501.790407597,46,1476.35126314504,65,1500,0,1485.79720130395,111,1456.6893386589,294,1462.20155843656,52,52,20,-0.88316437608119,294,138,-1.09644198078664
"Voltchkov V.",1477.3770891768,92,1500.03501379371,65,1488.64655621221,17,1432.38083552225,10,1500,0,1443.67350967371,27,1484.16038622242,73,1479.29559781206,19,19,8,0.731546296415794,73,32,-1.63646272934357
"Draper S.",1498.98936104121,54,1518.00893223419,35,1459.94344435097,14,1454.80891578844,5,1500,0,1437.4498641661,19,1521.18742463327,37,1419.45190431852,17,17,3,-2.19904263671935,37,16,2.15861707836769
"Davydenko N.",1594.88820117486,723,1653.24898493604,404,1451.39969567909,28,1551.56915771903,291,1500,0,1535.95914589393,319,1596.45883731413,591,1621.90313774128,132,132,82,2.20095331254172,591,344,1.59457473445283
"Kempes E.",1431.40683537342,24,1465.51539649215,13,1463.8142032083,3,1493.96679168277,8,1500,0,1458.010956154,11,1466.20940354668,21,1463.57778346717,3,3,0,-1.45964384916115,21,9,-1.28408273590203
"Roitman S.",1398.74693433783,85,1399.37540793118,17,1460.13825234506,6,1448.10305282293,62,1500,0,1430.3038757042,68,1427.86312328462,73,1408.93045114489,12,12,0,-2.51318502788713,73,25,-1.53693759859954
"van Scheppingen D.",1444.77167224065,47,1465.86707786772,20,1459.30739308623,10,1467.24103256121,17,1500,0,1443.65961267259,27,1461.22175515458,43,1459.95943465739,4,4,0,-1.44764107665606,43,16,-0.761492033718096
"Elsner D.",1389.62391016839,31,1456.10918322016,6,1487.5,1,1429.2959313561,24,1500,0,1416.64784435455,25,1408.74833411403,25,1463.71886180971,6,6,1,-1.15001876772137,25,7,-3.2650248255432
"Goellner M.K.",1453.71063022594,25,1504.36026899753,6,1475,2,1454.47053236602,17,1500,0,1440.69333345824,19,1458.07333544009,24,1486.90252653804,1,1,0,-0.366002004420408,24,9,-1.48557278654201
"Carretero R.",1497.28719457974,4,1500,0,1500,0,1498.74333997102,4,1500,0,1497.72521900723,4,1499.3724802189,4,1500,0,0,0,0,4,2,-0.108512216810501
"Martelli M.",1490.36235909317,5,1502.36625032467,2,1500,0,1488.68187583629,3,1500,0,1487.9677598063,3,1489.31175879075,5,1500,0,0,0,0,5,2,-0.385505636273244
"Puentes G.",1426.39258034244,22,1473.50585179913,5,1498.86993451853,2,1439.67818860236,15,1500,0,1438.18367993548,17,1432.53682440861,18,1481.67967146753,4,4,1,-0.438993024988208,18,5,-2.50530376131435
"Sanchez D.",1501.82828415604,197,1376.9496803471,44,1451.12200324835,4,1543.37718402404,149,1500,0,1532.4250815851,153,1494.46185029217,170,1445.35600410901,27,27,8,-2.85178382040045,170,77,2.92491518664205
"Schranz W.",1495.50460458306,2,1500,0,1500,0,1497.55857313612,2,1500,0,1497.25718962506,2,1496.25059058673,2,1500,0,0,0,0,2,1,-0.179815816677523
"Luzzi F.",1463.35524728342,42,1466.96652113429,11,1500,0,1477.3687634332,31,1500,0,1471.06331137806,31,1485.97746476774,36,1462.20713778994,6,6,1,-1.56645535895359,36,15,0.100665250290507
"Mathieu P.H.",1568.99003207474,500,1504.12907599478,242,1501.75699978028,52,1589.87854965822,206,1500,0,1589.24369987527,258,1571.32381167374,407,1522.75593913578,93,93,45,3.28762766644119,407,196,-0.528026383451401
"Motomura G.",1423.23256998622,20,1425.86133645588,17,1487.63643602396,3,1500,0,1500,0,1490.1911008876,3,1434.75551846555,18,1477.28955637168,2,2,0,-0.737632438754779,18,5,-2.33306476179631
"Furlan R.",1457.14280600579,18,1479.17388532439,11,1500,0,1470.45266870016,7,1500,0,1471.13238384352,7,1449.3527735253,16,1501.58400214536,2,2,1,0.215184557379652,16,5,-1.9294723171479
"Nargiso D.",1550.55720747875,11,1501.1638107866,2,1500,0,1556.91895841036,9,1500,0,1555.9522197125,9,1552.41173213968,11,1500,0,0,0,0,11,8,2.02228829915012
"Stoliarov A.",1446.71320062773,82,1448.36409731999,42,1461.88311815985,17,1452.07757007465,23,1500,0,1444.75127867077,40,1434.98397110345,70,1488.48229024811,12,12,5,0.840474639990809,70,26,-2.97194661488153
"Larose S.",1520.2305204792,12,1505.79605928409,12,1500,0,1500,0,1500,0,1500,0,1519.23226191848,12,1500,0,0,0,0,12,5,0.809220819167837
"Dent T.",1584.35989667324,270,1585.81603162491,203,1540.08238076847,51,1446.33114305443,16,1500,0,1517.21347583397,67,1552.18131899469,218,1568.86656716271,52,52,27,2.54018452724442,218,113,0.834211339685058
"Capalik K.",1470.05787443427,8,1483.93001241513,3,1501.07455327042,4,1487.94452789918,1,1500,0,1489.97927356832,5,1470.33257278565,8,1500,0,0,0,0,8,3,-1.19768502262921
"Kim K.",1426.74881315481,133,1428.7432796149,101,1423.41657018512,17,1445.42794559945,15,1500,0,1398.33232693549,32,1415.67404699864,112,1434.31891884011,21,21,6,-0.584327608197998,112,37,-2.34571986560951
"Taino E.",1467.95566896491,26,1472.8778847425,22,1500,0,1478.5858240172,4,1500,0,1478.03741010519,4,1479.43916097053,24,1475.30115326517,2,2,0,-0.852339860587304,24,10,-0.429433380816435
"Kralert P.",1477.97578807293,4,1500.19782632622,2,1500,0,1475.77593609507,2,1500,0,1475.44003140687,2,1474.22590808866,2,1500.3296011959,2,2,1,0.142218435825742,2,0,-1.0231869129087
"Lee H.T.",1556.27187888675,263,1558.7997619893,181,1505.52339427094,36,1509.27870016949,46,1500,0,1537.35257255549,82,1550.55959224334,212,1510.08180852724,51,51,22,1.27348516605528,212,96,0.977389989414544
"Pescariu D.",1490.64016550981,3,1500,0,1500,0,1491.9735992812,3,1500,0,1491.4488474616,3,1491.62608053423,3,1500,0,0,0,0,3,1,-0.374393379607742
"Erlich J.",1489.18468398546,9,1504.92009847706,6,1486.01841882072,3,1500,0,1500,0,1484.55717826185,3,1489.9517472838,9,1500,0,0,0,0,9,4,-0.432612640581562
"Tarallo S.",1497.34881358258,2,1500,0,1500,0,1498.39713943389,2,1500,0,1498.04828254527,2,1497.92192895308,2,1500,0,0,0,0,2,1,-0.10604745669698
"Flygt K.",1499.9297045896,4,1513.29846883224,3,1500,0,1488.88822930684,1,1500,0,1489.45178409065,1,1498.84750385968,4,1500,0,0,0,0,4,2,-0.00281181641611505
"Friedl L.",1490.86833314362,7,1472.15133251053,4,1500,0,1515.34065857746,3,1500,0,1514.41959474103,3,1491.80223178032,7,1500,0,0,0,0,7,3,-0.365266674255092
"Suzuki T.",1553.35976898005,37,1552.35431296409,34,1489.09726226904,3,1500,0,1500,0,1484.70040930217,3,1553.54804976611,31,1484.97577011567,6,6,2,-0.572246106956221,31,16,2.70663686615808
"Yoon Y.",1490.15341782397,7,1497.44390046751,6,1489.14061342703,1,1500,0,1500,0,1489.77483020098,1,1495.91619937763,6,1491.80373335183,1,1,0,-0.296534777058225,6,3,-0.0973285099828513
"Viloca J.A.",1502.32385751487,12,1506.13287616209,6,1500,0,1502.13057943772,6,1500,0,1500.80082864872,6,1502.80973126812,12,1500,0,0,0,0,12,6,0.0929543005949011
"Palmer J.",1510.64623802366,4,1517.84404858848,3,1487.5,1,1500,0,1500,0,1487.83314886987,1,1509.46565481303,4,1500,0,0,0,0,4,2,0.425849520946438
"Childs L.",1443.3315725004,10,1498.83729298357,2,1436.37904978334,8,1500,0,1500,0,1440.65774143771,8,1464.54160096841,5,1467.68441319907,5,5,1,-0.845234527885673,5,1,-1.42150257209829
"Froberg J.",1506.74686195629,2,1505.5642924567,2,1500,0,1500,0,1500,0,1500,0,1505.50588545957,2,1500,0,0,0,0,2,1,0.269874478251706
"Ortegren J.",1501.55628851447,2,1502.20597498572,2,1500,0,1500,0,1500,0,1500,0,1501.73370378604,2,1500,0,0,0,0,2,1,0.0622515405787053
"Phau B.",1521.89872149342,208,1494.89555073378,137,1395.92684901184,14,1485.80714601057,57,1500,0,1456.8549034628,71,1524.83700846828,176,1401.32785313639,32,32,7,-3.17328100203407,176,70,4.0492298617708
"Pless K.",1397.87494691303,112,1422.37709087287,71,1424.39499640188,16,1438.74604375633,25,1500,0,1393.74775557567,41,1392.18945331636,85,1441.85506494869,27,27,9,0.804619833970819,85,29,-4.8896219574496
"Robredo T.",1668.99063104018,805,1654.91750673859,387,1542.92122491526,54,1671.55956892128,364,1500,0,1654.6153179713,418,1667.5498116048,639,1683.87421272572,166,166,108,5.71407831985279,639,388,1.04554692175415
"Weiner G.",1435.88632001545,30,1432.86636208961,25,1490.56849111197,5,1500,0,1500,0,1488.00388963724,5,1439.99384907901,26,1475.72446827876,4,4,1,-0.467269738215656,26,9,-2.09727746116633
"Burgsmuller L.",1411.81957834009,171,1424.13988663015,101,1448.73670883106,23,1406.09620307238,47,1500,0,1412.36940053958,70,1396.02660978495,139,1445.81781698613,32,32,11,0.0357324931823106,139,50,-3.56294935957861
"Armando H.",1446.8402706325,43,1502.80827052949,5,1500,0,1423.7348136858,38,1500,0,1424.94228239434,38,1454.59038189297,41,1477.94649792289,2,2,0,-0.792736978508834,41,13,-1.33365219619119
"Hadad M.",1498.21634631852,4,1500,0,1500,0,1499.34518111631,4,1500,0,1498.148214568,4,1499.46893776318,4,1500,0,0,0,0,4,2,-0.0713461472591396
"Hirigoyen I.",1480.48213839231,4,1488.65424741998,1,1500,0,1485.63676786699,3,1500,0,1486.1086574629,3,1478.36565197731,4,1500,0,0,0,0,4,1,-0.780714464307585
"Nalbandian D.",1745.6702985261,493,1745.13515385225,262,1640.3585093789,42,1723.10354519246,189,1500,0,1723.32111658849,231,1752.05711353354,368,1666.3971932878,125,125,87,5.21226201017277,368,235,4.61454993087109
"Simoni A.",1418.40510713722,30,1448.5370604126,15,1465.02136662538,5,1490.55648995554,10,1500,0,1451.37247864896,15,1427.8983314314,26,1474.51766779327,4,4,1,-0.715944153180556,26,9,-2.54785156133071
"Tobon M.",1498.17253187625,2,1500,0,1500,0,1500.06674213707,2,1500,0,1500.02841153771,2,1498.4934427173,2,1500,0,0,0,0,2,1,-0.0730987249500865
"Mahut N.",1667.30552314979,331,1549.45286159635,186,1708.51336923312,98,1460.80987253388,47,1500,0,1690.69122071407,145,1622.23060134478,261,1539.61658150531,70,70,26,-3.23451373617098,261,126,9.92673466216253
"Lopez F.",1706.57673862706,753,1691.98802126349,438,1658.21862054461,96,1627.5324074738,219,1500,0,1655.15571091141,315,1673.52628719893,604,1684.89801661208,149,149,88,8.28739208414809,604,311,-0.0243225390656745
"Acasuso J.",1603.01014031556,347,1522.37877427833,106,1406.23450245494,8,1636.95151789384,233,1500,0,1623.01097513415,241,1599.40538772687,301,1428.15151662921,46,46,14,-6.86602003439198,301,163,10.9864256470144
"Tursunov D.",1564.8103220452,401,1583.91754088789,267,1553.09021272154,63,1503.33501410556,71,1500,0,1533.64267531397,134,1591.5367945167,320,1466.24642339829,81,81,38,-2.24665577380638,320,171,4.83906865561447
"Saretta F.",1507.7677397654,141,1484.88840061991,40,1500.4445191567,12,1541.1936807279,89,1500,0,1523.67602730487,101,1521.98028010869,112,1471.15327238906,29,29,12,-0.469532578348867,112,55,0.78024216896482
"Montanes A.",1560.16655071866,533,1415.26938877915,118,1454.4160104523,19,1586.09648796768,396,1500,0,1567.29558478415,415,1595.47904725986,450,1426.20679014851,83,83,30,-8.86394293707533,450,223,11.2706049658217
"Thomann N.",1474.32741859073,28,1513.72812137879,18,1488.49185415075,3,1444.01888709541,7,1500,0,1437.60567720418,10,1478.12809624754,24,1481.6774883224,4,4,1,-0.417085225275591,24,9,-0.609818031095179
"Gross O.",1448.02501765064,12,1487.92866525186,1,1487.41403230829,1,1464.41146216869,10,1500,0,1451.29849806791,11,1446.8693762051,12,1500,0,0,0,0,12,3,-2.07899929397456
"Blake J.",1575.33417598982,544,1594.69575070216,409,1523.22556275976,56,1549.64023078597,79,1500,0,1521.06206723872,135,1585.92613318658,441,1562.63855753505,103,103,60,-2.07427160414735,441,268,5.08763864374034
"Santopadre V.",1491.66898548458,3,1500,0,1500,0,1491.73120008826,3,1500,0,1491.13796680667,3,1490.68234795393,3,1500,0,0,0,0,3,1,-0.333240580616662
"Traykov I.",1500.0993172076,2,1500,0,1500,0,1499.25618958016,2,1500,0,1498.80867197419,2,1500.5656451864,2,1500,0,0,0,0,2,1,0.00397268830417952
"Andersen J.F.",1474.49530753935,8,1487.95689990999,1,1500,0,1479.86660652713,7,1500,0,1480.26265612599,7,1468.15191561768,6,1502.55759161381,2,2,1,0.234342430233478,6,1,-1.25453012865958
"Ondruska M.",1445.64149028343,8,1445.50741162142,5,1487.5,1,1507.7927620527,2,1500,0,1494.5630760593,3,1438.63195662452,5,1488.21777391325,3,3,1,0.172171097803184,5,0,-2.34651148646592
"Elseneer G.",1431.59856853617,35,1439.52469623801,10,1479.51964041581,20,1491.41532137286,5,1500,0,1467.54772801128,25,1432.43499820473,25,1478.31686011058,10,10,4,-0.0855857484221001,25,9,-2.65047151013095
"Allegro Y.",1452.42879037777,13,1472.1956524639,2,1472.3667876306,10,1492.3838084616,1,1500,0,1470.51417216734,11,1450.30184014959,13,1500,0,0,0,0,13,4,-1.90284838488902
"Carlsen K.",1498.82634460308,176,1522.84255060477,126,1479.31279681028,32,1396.1661614678,18,1500,0,1419.85596264298,50,1510.86897390922,152,1393.47250227341,24,24,5,-4.71038113122867,152,71,4.66343491535174
"Settergren J.",1482.31013374136,6,1475.0270380815,2,1500,0,1504.31482399519,4,1500,0,1502.31222902695,4,1482.16644284563,6,1500,0,0,0,0,6,2,-0.707594650345665
"Mutis O.",1463.60433807591,59,1430.52191769814,15,1487.44708412932,5,1516.41142912391,39,1500,0,1507.83737649983,44,1458.33918864262,47,1490.23312309691,12,12,5,0.620888791942972,47,19,-2.07671526890671
"Lopez M.",1474.28485972677,52,1497.72197089525,3,1493.30646161167,3,1477.31173578995,46,1500,0,1467.33103412161,49,1491.37086406688,47,1468.70555122222,5,5,1,-1.41480302836205,47,20,0.386197417432676
"Wassen R.",1467.72495968922,8,1499.66122424192,2,1488.39731929921,1,1474.28586966236,5,1500,0,1462.51631009328,6,1468.51245076401,8,1500,0,0,0,0,8,2,-1.29100161243135
"Horna L.",1509.03437749133,246,1455.60009000294,81,1432.78371088188,6,1572.74913405526,159,1500,0,1545.59296970766,165,1545.64508868916,212,1388.3178849328,34,34,9,-6.51692534905279,212,104,6.87830044870589
"Serrano O.",1483.10821938505,8,1500,0,1500,0,1485.15762018709,8,1500,0,1483.22031507494,8,1493.31388462305,7,1487.05047029068,1,1,0,-0.520968590786762,7,3,-0.154702633811286
"Kutsenko V.",1466.30977053172,10,1461.99545198723,8,1500,0,1502.29395585946,2,1500,0,1500.98490695978,2,1468.27332268133,7,1487.26976581124,3,3,1,-0.0444140468344343,7,2,-1.30319513189681
"Marach O.",1448.98920701848,42,1467.74292356193,11,1486.96731614586,1,1475.42463653845,30,1500,0,1464.60763625122,31,1476.18089369568,37,1442.12168560507,5,5,0,-2.18519158817437,37,15,0.144759868913515
"Peya A.",1383.1669798289,58,1454.27142649438,21,1418.85560884644,15,1431.51638558649,22,1500,0,1376.9531575832,37,1397.06235056421,47,1456.49949624632,11,11,3,-0.819999076482212,47,12,-3.85332173036161
"Trifu G.",1457.98243466558,8,1500,0,1475.88649878002,2,1481.98609728881,6,1500,0,1457.2891287403,8,1457.89480365453,8,1500,0,0,0,0,8,2,-1.68070261337678
"Vacek J.",1447.00883730996,88,1365.35525179699,44,1518.74785285903,29,1447.65430152932,15,1500,0,1503.31293420375,44,1453.74732248099,73,1445.67732994907,15,15,4,-1.41036314755283,73,26,-0.709283360048607
"Ginepri R.",1542.87003389668,358,1504.5550934081,266,1479.92016521174,50,1514.16409202883,42,1500,0,1529.73853526113,92,1535.87948860377,291,1512.7746176099,67,67,31,0.105490296846165,291,144,1.60931105902091
"Cuadrado C.",1509.93714614551,8,1500,0,1500,0,1510.70340853554,8,1500,0,1509.64805919964,8,1511.21393405687,8,1500,0,0,0,0,8,4,0.397485845820386
"Labadze I.",1499.07082526069,113,1443.95355927454,49,1480.73212503994,14,1458.7327949944,50,1500,0,1493.06454160311,64,1445.9861452368,93,1478.56624268511,20,20,7,0.916187746833552,93,32,-0.953354736406125
"Behr N.",1493.46353413801,9,1495.70355872808,9,1500,0,1500,0,1500,0,1500,0,1493.08686266025,9,1500,0,0,0,0,9,4,-0.261458634479489
"Okun N.",1427.1555174657,58,1427.27760739616,47,1441.8056962402,7,1502.24564956896,4,1500,0,1445.48086463801,11,1431.02180241867,49,1452.26906839703,9,9,2,-1.44485412996836,49,17,-1.46892517140365
"Joyce M.",1501.16884593993,6,1501.6415613532,6,1500,0,1500,0,1500,0,1500,0,1501.25298130303,6,1500,0,0,0,0,6,2,0.0467538375970916
"Kim A.",1410.2672546243,32,1424.42800762658,25,1488.27064638523,3,1455.84597240351,4,1500,0,1450.74861646769,7,1424.42917374195,24,1466.08440887783,8,8,2,-0.700950171347103,24,6,-2.8883596436808
"Brasington J.",1448.84229449826,10,1460.39706552697,6,1486.37537632024,1,1488.34238735941,3,1500,0,1474.24271534259,4,1483.85840257723,2,1450.94734601539,8,8,2,-1.52641251970498,2,0,-0.519895700364761
"Ramirez Hidalgo R.",1486.84137149621,16,1500,0,1500,0,1481.71668493843,16,1500,0,1479.8377169691,16,1486.49709788203,16,1500,0,0,0,0,16,6,-0.526345140151443
"Mello R.",1448.05835832952,135,1441.35135353855,77,1432.42530829728,9,1476.26522074674,49,1500,0,1448.08198530157,58,1443.89004837183,111,1433.6330729503,24,24,7,-0.482295025250293,111,44,-1.59537064156895
"Ogorodov O.",1478.61715721808,12,1474.22315537396,9,1500,0,1500.1080871655,3,1500,0,1499.73656253526,3,1470.05245155111,10,1499.34062938936,2,2,1,0.211298286962462,10,3,-1.06661199823925
"Tebbutt M.",1486.96156616539,3,1487.75162174246,3,1500,0,1500,0,1500,0,1500,0,1486.31533318245,3,1500,0,0,0,0,3,1,-0.521537353384326
"Terachi T.",1464.38346477159,11,1468.27313712506,11,1500,0,1500,0,1500,0,1500,0,1462.71810789487,11,1500,0,0,0,0,11,4,-1.42466140913624
"Fukarek O.",1397.63841465694,14,1418.2674794086,9,1488.19191033066,3,1476.19943129508,2,1500,0,1465.33954499326,5,1415.4690213532,12,1474.93904760831,2,2,0,-0.937618791952094,12,2,-3.15684462177036
"Kondo H.",1476.07262951332,4,1473.03822064101,4,1500,0,1500,0,1500,0,1500,0,1475.50069262547,4,1500,0,0,0,0,4,1,-0.9570948194674
"Udomchoke D.",1349.38633292375,69,1356.39256712527,49,1446.57227859241,16,1464.33805304397,4,1500,0,1423.73263451227,20,1342.80511247842,55,1465.77816972278,14,14,4,0.508088685215266,55,13,-6.53263536826531
"Melzer J.",1608.0449933115,610,1573.98448408561,320,1581.31629578527,70,1578.77205322071,220,1500,0,1591.65494487769,290,1593.28321616876,500,1595.33716233463,110,110,59,2.67957573682974,500,259,1.64222399563032
"Nieminen J.",1541.01350535018,660,1537.94513673421,422,1481.9963464005,55,1539.33498328283,183,1500,0,1526.14635794045,238,1519.50934395585,553,1559.80289807719,107,107,54,2.57195057431919,553,288,-0.931410360312052
"Soderling R.",1970.64933001738,420,1910.74289627108,257,1639.99316860497,43,1842.77366019095,120,1500,0,1873.22713286931,163,1943.69406909939,339,1768.99002551149,81,81,51,4.39048335573488,339,212,14.4354898449602
"Galvani S.",1428.61635476299,49,1445.97842192824,16,1486.31118046938,7,1434.33253919104,26,1500,0,1444.67958039816,33,1431.50161626286,35,1449.30815839088,14,14,4,-0.839146242724487,35,11,-2.01619956675607
"Karlovic I.",1777.46040466161,569,1717.76093146354,355,1698.82119092184,100,1574.69212757631,114,1500,0,1685.87854346443,214,1746.58144589803,476,1580.37099928459,93,93,44,-1.47867605757905,476,263,12.5770922440437
"Knowle J.",1396.26096894957,39,1422.71707223907,16,1462.57350995502,12,1429.37580084565,11,1500,0,1417.54367111511,23,1393.6412559374,30,1471.93998177905,9,9,3,0.0381893446019669,30,6,-4.18775058661911
"Stepanek R.",1666.80860251831,590,1608.52727325366,356,1625.74454866078,71,1609.55965297363,163,1500,0,1656.02765030595,234,1689.89201520209,478,1525.70991218953,112,112,57,-6.42382499666074,478,276,13.0961690973931
"Nielsen M.",1437.25560862746,9,1435.01724755658,9,1500,0,1500,0,1500,0,1500,0,1436.7958144466,9,1500,0,0,0,0,9,1,-2.50977565490166
"Bachelot J.F",1485.27016671284,6,1508.18210248048,2,1478.54089568452,2,1499.78700130664,2,1500,0,1475.93887819133,4,1481.36633372482,3,1493.21252839717,3,3,1,0.164726100313571,3,1,-0.753919431799811
"Carraz G.",1487.86381894901,71,1489.87565014024,52,1484.2992341443,15,1469.35459083009,4,1500,0,1471.25949392158,19,1474.49052251834,59,1493.89429589024,12,12,5,0.776660653419801,59,24,-1.26210789545928
"Gicquel M.",1480.56650772384,184,1534.98789329466,99,1466.50455882331,26,1488.36313178984,59,1500,0,1444.53541534246,85,1517.88748634496,145,1466.85695838713,39,39,15,0.312401468805577,145,65,-1.08974115985217
"Silva J.",1439.28988367046,11,1473.80186940137,2,1500,0,1448.02500625353,9,1500,0,1450.19703153057,9,1456.89120129162,9,1473.12480050081,2,2,0,-0.837495024601871,9,2,-1.59090962857986
"Morrison J.",1454.59764424525,85,1462.22967137591,65,1467.35379109946,16,1483.21416415258,4,1500,0,1453.64468949175,20,1477.82606976122,73,1443.24514739432,12,12,3,-1.51491856437566,73,29,-0.30117566581418
"El Aarej M.",1446.56205202933,7,1500,0,1500,0,1447.81859925108,7,1500,0,1446.73464632446,7,1447.08187341263,7,1500,0,0,0,0,7,1,-2.1375179188269
"Gasquet R.",1821.30200106488,675,1772.00994237972,411,1685.06830926845,80,1810.50079468169,184,1500,0,1815.82357505922,264,1780.88086131006,531,1807.56695342668,144,144,96,5.82510631257454,531,334,7.02697373002077
"Krajan Z.",1398.63581743783,33,1451.18220608497,8,1487.14744174243,1,1426.13563115781,24,1500,0,1417.17334923853,25,1410.70746176706,30,1465.57803820803,3,3,0,-0.85403801380565,30,8,-3.20052928868108
"Perez D.",1447.65217644235,7,1500,0,1500,0,1443.57977797846,7,1500,0,1444.44538154455,7,1458.05824335454,6,1487.09378297823,1,1,0,-0.518771191901137,6,1,-1.57514175040484
"Nadal-Parera R.",1497.76935180824,2,1500,0,1500,0,1500.8683590741,2,1500,0,1500.66964691233,2,1497.27888322682,2,1500,0,0,0,0,2,1,-0.0892259276703069
"Galimberti G.",1436.5371202294,18,1453.62610290169,6,1500,0,1469.01149773497,12,1500,0,1465.69329429775,12,1444.89618625574,12,1475.80350092914,6,6,2,-0.606657614582023,12,3,-1.93185757624197
"de Chaunac S.",1448.66626743134,20,1446.83597668544,16,1500,0,1481.85766885121,4,1500,0,1480.35236174063,4,1449.86726470331,16,1481.97325998507,4,4,1,-0.489265283399,16,4,-1.56408401934758
"Hadad A.",1500.7704293892,6,1503.90923461661,4,1500,0,1501.12298920912,2,1500,0,1500.23823195251,2,1499.62001868701,4,1499.2876455698,2,2,1,0.00444989209345337,4,2,0.0263672834746151
"Ancic M.",1758.58181881154,273,1727.09628561573,168,1710.82736149015,50,1639.05147712916,55,1500,0,1747.34221229544,105,1705.68524621571,210,1721.04589936518,63,63,43,9.48967795678216,210,124,0.853594795679423
"Beck K.",1408.13978926602,155,1426.05684657457,102,1468.31390911826,31,1365.39822494266,22,1500,0,1417.8067883665,53,1410.13789120962,118,1455.61616098974,37,37,13,1.16339647581686,118,38,-4.83780490517601
"Waske A.",1452.89417315192,85,1412.28617177812,29,1439.35174561566,15,1461.0419614422,41,1500,0,1459.45992861901,56,1467.93368147399,72,1416.8131126461,13,13,2,-2.59906753196728,72,24,0.714834458043908
"Fraile G.",1434.1811653389,9,1492.58506531759,1,1500,0,1439.68272176423,8,1500,0,1437.11632225268,8,1434.34692266125,9,1500,0,0,0,0,9,1,-2.63275338644389
"Blake T.",1471.92854531249,8,1483.04176177315,5,1499.91429368542,2,1487.5,1,1500,0,1486.96525423029,3,1471.25482010977,8,1500,0,0,0,0,8,3,-1.12285818750061
"Vahaly B.",1398.08141356153,64,1417.58055727162,47,1463.70103149237,10,1448.21628925943,7,1500,0,1428.22407531496,17,1402.81886213246,56,1461.11388299343,8,8,1,-1.12601348346121,56,20,-2.95072997407776
"Verkerk M.",1489.37751462931,105,1456.62227480378,42,1470.92893054915,9,1541.02858994635,54,1500,0,1512.23742042298,63,1477.07580758252,86,1531.1758806274,19,19,10,2.0698975231796,86,36,-2.49479693800736
"Ferrer D.",1794.93991935439,955,1800.37851436841,482,1637.36108136877,59,1864.59113852714,414,1500,0,1795.01841130629,473,1766.04046557,759,1830.88953011986,196,196,141,2.99208276348112,759,502,8.80551401069422
"Hanescu V.",1564.80324153711,397,1463.60898982409,138,1463.22073836474,32,1618.84466882803,227,1500,0,1589.29626114976,259,1560.62133456226,327,1501.47614418968,70,70,31,1.72594743653205,327,150,0.866182224952215
"Radic M.",1482.10542809766,6,1500,0,1500,0,1478.96344622352,6,1500,0,1476.52521031707,6,1481.87147440737,6,1500,0,0,0,0,6,2,-0.7157828760937
"Schiessling T.",1484.77669291191,4,1500,0,1500,0,1486.90443934075,4,1500,0,1485.21116807914,4,1485.18290574098,4,1500,0,0,0,0,4,1,-0.608932283523739
"Bogomolov Jr.A.",1484.14122863274,4,1480.84334322678,4,1500,0,1500,0,1500,0,1500,0,1509.0633641339,2,1475.13251400644,2,2,0,-1.05048267610741,2,1,0.41613182141712
"Verdasco F.",1663.26953990202,750,1599.12705970453,368,1605.26045893185,74,1683.57042063204,308,1500,0,1682.66250527596,382,1641.46073553339,601,1669.78185588975,149,149,94,7.94759471489688,601,339,-1.41681311881596
"Dancevic F.",1480.64637132485,135,1431.16330007926,89,1506.05829748757,42,1453.47004454462,4,1500,0,1486.4051755557,46,1508.47586176851,111,1407.76355470594,24,24,5,-3.93805709593072,111,46,3.16391194892475
"Norman D.",1416.01310558628,51,1441.23948818756,16,1474.10399190291,19,1418.61511541767,16,1500,0,1422.19713995554,35,1411.60445071405,37,1449.46666882976,14,14,4,-0.180023763022334,37,9,-3.17945201352641
"Giner J.",1491.87934640487,5,1500,0,1500,0,1495.53195187242,5,1500,0,1493.39533272534,5,1492.03044562892,5,1500,0,0,0,0,5,2,-0.32482614380537
"Washington M.",1465.08004267545,5,1466.22507326402,5,1500,0,1500,0,1500,0,1500,0,1465.44490931277,5,1500,0,0,0,0,5,1,-1.39679829298205
"Johansson J.",1668.37063024585,113,1683.42073367539,88,1517.72107305863,12,1418.34946643593,13,1500,0,1450.85642246816,25,1642.90866453747,89,1592.44325165267,24,24,15,4.36888347561563,89,48,2.36594173421838
"Vliegen K.",1466.47140174678,183,1464.1111833608,84,1452.98751554503,27,1503.95288448643,72,1500,0,1478.33906338155,99,1504.17852089618,151,1396.56503918109,32,32,9,-5.00504879900289,151,68,3.66390486887404
"Lisnard J.R.",1426.48943226109,87,1455.78128232361,46,1468.32163590239,5,1424.95732138695,36,1500,0,1413.10338779219,41,1425.50920264803,67,1466.18413986211,20,20,7,0.276919171007329,67,23,-3.21734188056382
"Van Lottum J.",1498.47502013194,3,1498.11337442831,3,1500,0,1500,0,1500,0,1500,0,1498.39957468024,3,1500,0,0,0,0,3,1,-0.0609991947223129
"Hantschek M.",1504.71246185663,2,1503.42662251424,2,1500,0,1500,0,1500,0,1500,0,1504.29591418124,2,1500,0,0,0,0,2,1,0.188498474265304
"Luczak P.",1437.57773631645,114,1446.78882431306,53,1515.72414523852,8,1401.86704400394,53,1500,0,1427.49883548886,61,1439.04638918141,91,1431.21685227504,23,23,6,-0.518596136280212,91,29,-1.97829441106169
"Crabb J.",1443.88520813681,8,1441.79583704863,8,1500,0,1500,0,1500,0,1500,0,1446.98509150031,5,1490.25482165373,3,3,1,-0.166745345885608,5,0,-2.07784632864213
"Larkham T.",1476.29587851841,7,1500.25980183757,4,1489.11088974371,1,1478.3084428073,2,1500,0,1470.14926984882,3,1492.98686795467,1,1472.71080878723,6,6,1,-0.702468877008935,1,0,-0.245695982254763
"Sirianni J.",1484.33449920911,20,1492.15811594416,15,1464.7093607482,5,1500,0,1500,0,1467.11753518472,5,1490.8271872298,16,1480.72916186214,4,4,1,-0.56176921426171,16,6,-0.064850817373775
"Cadart R.",1480.30151600161,6,1505.89495821209,4,1485.57420210951,1,1486.79775724438,1,1500,0,1471.69711554435,2,1490.44905497728,5,1487.5,1,1,0,-0.499953510214668,5,2,-0.287985849720891
"Gambill J. M.",1497.78934601695,4,1495.82962773465,4,1500,0,1500,0,1500,0,1500,0,1497.02597266906,4,1500,0,0,0,0,4,2,-0.0884261593221844
"Fleishman Z.",1456.01278103849,24,1446.1311206218,21,1489.60446001238,3,1500,0,1500,0,1489.80781136985,3,1455.35934087389,20,1476.25384322543,4,4,1,-0.281981319255524,20,6,-1.47750743920491
"Daniel M.",1382.00521905419,83,1352.50505642622,22,1453.84710630248,7,1462.29585743617,54,1500,0,1448.37906309823,61,1413.32294066853,66,1382.48688213238,17,17,1,-3.57743744182172,66,19,-1.14235379601078
"Gamonal H.",1470.33060049459,7,1485.27379139368,1,1500,0,1483.06582208347,6,1500,0,1480.95188532668,6,1482.88255713233,6,1486.54451079707,1,1,0,-0.564911116812881,6,2,-0.621864863403367
"Massa E.",1467.25410051838,24,1493.37464244244,5,1487.0274228142,1,1471.79877974597,18,1500,0,1460.65361142561,19,1478.22936212282,22,1476.37512029421,2,2,0,-0.854995422460895,22,8,-0.454840556803721
"Melo D.",1475.681709988,5,1484.51722534577,1,1500,0,1487.65845588033,4,1500,0,1486.76552974888,4,1476.3467605016,5,1500,0,0,0,0,5,1,-0.972731600480108
"Marin J.A",1508.40589356489,2,1500,0,1500,0,1504.78188403365,2,1500,0,1504.16451701585,2,1508.25707457984,2,1500,0,0,0,0,2,1,0.336235742595525
"Miranda I.",1467.11736238207,19,1458.92221390561,9,1510.16310149021,3,1492.63363469527,7,1500,0,1499.25581650842,10,1483.67653537525,16,1470.35669868538,3,3,0,-0.950223966279785,16,7,-0.365081538437418
"Abel M.",1463.19119823756,9,1473.85642117951,5,1491.03469087827,1,1490.34472570365,3,1500,0,1481.13640638596,4,1469.25851301163,8,1484.73480490051,1,1,0,-0.42863508434568,8,2,-1.04371698615185
"Kendrick R.",1436.16812285251,112,1471.56203805905,82,1423.06499419789,18,1433.1727749698,12,1500,0,1384.80252478139,30,1435.71910686472,91,1427.75507529095,21,21,4,-1.31872409431102,91,31,-1.23455099158835
"Di Pasquale A.",1471.19843884428,5,1464.54488769263,5,1500,0,1500,0,1500,0,1500,0,1482.09229302427,4,1487.64845753475,1,1,0,-0.527431173758859,4,1,-0.624631272470121
"Lapentti G.",1415.70358716766,29,1466.4467699699,17,1484.94721989676,3,1432.24988518374,9,1500,0,1422.97642349314,12,1429.96116456154,26,1467.94841348,3,3,0,-0.962516322716991,26,7,-2.40934019057674
"Prodon E.",1361.40066989176,20,1467.66645158551,3,1500,0,1373.7348670907,17,1500,0,1376.58782560923,17,1397.1200839137,13,1441.07499489609,7,7,0,-1.70899428184669,13,1,-3.83497892248306
"Mota B.",1493.24142381164,3,1500,0,1500,0,1487.25770113251,3,1500,0,1489.90664117084,3,1491.87908123015,3,1500,0,0,0,0,3,1,-0.270343047534228
"Volandri F.",1358.45592810565,366,1272.73291570881,63,1415.57534795573,13,1409.46882246179,290,1500,0,1397.90646117404,303,1377.51368473527,322,1345.58130240244,44,44,9,-10.5562319332412,322,155,4.89446905746744
"Benneteau J.",1618.02924826668,486,1595.19039709721,318,1522.72768039864,64,1511.86935290396,104,1500,0,1525.61428305168,168,1637.58576049807,395,1538.44620749143,91,91,42,-0.590016270334825,395,191,5.31118620100175
"Nadal R.",1992.26718337224,929,1900.20064147231,474,1736.90282593034,75,2106.45424192685,380,1500,0,2055.20319219629,455,1986.90078763334,686,1989.5529050303,243,243,211,12.8109891435056,686,555,6.87969819138419
"Srichaphan N.",1500.73519482735,2,1500,0,1500,0,1502.1627701472,2,1500,0,1501.91274977759,2,1499.95396144242,2,1500,0,0,0,0,2,1,0.0294077930940201
"Cermak F.",1471.7791380674,24,1462.82863920156,3,1502.57793004165,2,1506.34856965852,19,1500,0,1504.64032603835,21,1468.79396878192,24,1500,0,0,0,0,24,9,-1.12883447730414
"Schuettler P.",1513.53330940332,3,1500,0,1500,0,1514.49975089567,3,1500,0,1514.4276931387,3,1512.48291713243,3,1500,0,0,0,0,3,2,0.541332376132845
"Kohlschreiber P.",1733.87649071432,623,1654.96705410261,325,1672.81986012025,81,1740.83104024444,217,1500,0,1756.86603391277,298,1750.86950935927,514,1617.61841240089,109,109,60,1.64118412538628,514,289,7.71387550318657
"Varlet J.",1451.27444277425,8,1456.54936609856,4,1500,0,1482.06636767031,4,1500,0,1482.08501690266,4,1454.64368115897,4,1480.57151928165,4,4,1,-0.250451786508358,4,0,-1.69857050252156
"de Voest R.",1511.77884847407,27,1501.50186465761,22,1494.9526353209,5,1500,0,1500,0,1500.47209601145,5,1513.65421234073,24,1492.93385190619,3,3,1,-0.229262910349636,24,10,0.700416849312557
"Bogdanovic A.",1416.8640419547,37,1471.72598526923,5,1402.11090425871,32,1500,0,1500,0,1403.36829756699,32,1453.34734952903,28,1422.68894901359,9,9,0,-2.77616605660507,28,10,-0.549272265207041
"Reid T.",1510.28023379128,35,1497.46578170357,26,1484.41054061916,8,1487.01679372319,1,1500,0,1469.99168096158,9,1523.53183520205,27,1464.53582866808,8,8,2,-1.09782658390879,27,12,1.50903593556002
"Zimonjic N.",1469.78650450356,12,1465.60691461373,3,1506.23586161223,4,1474.44134709143,5,1500,0,1485.50945536783,9,1475.96768921841,11,1486.30393074448,1,1,0,-0.518727757933325,11,3,-0.689812061924463
"Baccanello P.",1463.17012422411,9,1462.34508732077,7,1499.21945762656,2,1500,0,1500,0,1497.44089494348,2,1470.60785491581,6,1489.2850901182,3,3,1,-0.322367696476118,6,1,-1.15082733455936
"Niemeyer F.",1465.29812705476,20,1444.02170266892,17,1489.16908791275,3,1500,0,1500,0,1495.90022985364,3,1453.23192910542,18,1500.33774952121,2,2,1,0.346077111853032,18,3,-1.73415202966267
"Moodie W.",1557.43992247172,103,1545.92363668872,77,1496.32477551111,21,1464.75893588629,5,1500,0,1473.34882177803,26,1537.60789049283,88,1502.26636742015,15,15,6,1.05777219827903,88,38,1.23982470058991
"Rehnquist B.",1459.36554129165,13,1439.1291374197,7,1500,0,1507.70950382813,6,1500,0,1507.58350412497,6,1474.49633981521,10,1473.6133042315,3,3,0,-0.910756475179116,10,3,-0.714621873154873
"Vemic D.",1491.14588523025,21,1477.67187668254,5,1501.58824769221,6,1509.85444044314,10,1500,0,1500.85206206066,16,1501.04859821647,20,1486.12484633975,1,1,0,-0.574490227162666,20,9,0.220325636372801
"Guccione C.",1497.18321012542,88,1529.80796916309,64,1437.07998030062,16,1458.56880431919,8,1500,0,1414.03249394714,24,1511.8417113262,71,1416.67281617198,17,17,4,-3.10951692252055,71,30,2.99684532753735
"Hernandez O.",1424.83935279146,186,1343.01207533111,33,1419.77813278713,10,1497.29605946025,143,1500,0,1472.12793165016,153,1460.55503087736,156,1368.39609320537,30,30,6,-4.40130852370222,156,58,1.39488263536075
"Wawrinka S.",1916.34466303156,629,1880.01027114573,352,1610.60127689618,48,1899.00920492818,229,1500,0,1868.40961263067,277,1820.03121596817,466,1951.51955446407,163,163,118,15.0382085790102,466,287,1.61557794225211
"Ram R.",1503.76997859451,145,1460.04479222103,101,1539.25179079692,34,1464.45013670425,10,1500,0,1507.94982792188,44,1507.19423741436,124,1430.95168989296,21,21,5,-2.3879862351206,124,49,2.53878537890123
"Delic A.",1494.95981011213,75,1506.89240591791,60,1472.15773583468,8,1459.20568356576,7,1500,0,1434.73523638246,15,1453.40704541164,58,1508.44101148473,17,17,7,2.19334675546239,58,18,-2.39495435097709
"Amritraj P.",1473.11593327417,35,1398.92541435632,22,1539.41281804835,13,1500,0,1500,0,1536.46516763105,13,1474.78787104158,34,1486.44205666487,1,1,0,-0.303576530136039,34,13,-0.771786138897079
"Bogomolov Jr. A.",1477.70665632685,9,1471.74273127158,9,1500,0,1500,0,1500,0,1500,0,1492.88865677599,7,1476.15135713922,2,2,0,-0.824830187569725,7,3,-0.0669035593562497
"Tipsarevic J.",1605.50518265485,425,1622.98152867389,267,1564.22859002829,60,1576.19622015956,98,1500,0,1581.41592219345,158,1596.54093124101,331,1633.75570452392,94,94,50,5.13719971636778,331,172,-0.916992410173734
"Mergea F.",1502.93043629962,4,1500,0,1500.04196309118,2,1500.63020755964,2,1500,0,1500.96466049739,4,1501.14756251321,4,1500,0,0,0,0,4,2,0.117217451984913
"Tuksar S.",1454.8743095512,7,1485.81793568378,1,1500,0,1466.68935046227,6,1500,0,1464.35669608858,6,1468.14686737676,5,1479.12976547833,2,2,0,-0.493095964333569,5,1,-1.31193165361838
"Youzhny A.",1519.8032376926,5,1508.94538573383,5,1500,0,1500,0,1500,0,1500,0,1517.38795264242,5,1500,0,0,0,0,5,2,0.7921295077041
"Berdych T.",1888.57433946626,789,1845.44376704966,516,1718.92609272409,82,1840.29828234764,191,1500,0,1849.00729616018,273,1828.28053225947,607,1873.20504040052,182,182,130,12.8874034127802,607,387,2.65557016587039
"Andreev I.",1532.84293761276,403,1526.38835738883,171,1498.2770217184,33,1542.48184890502,199,1500,0,1524.5798892673,232,1556.6725075166,334,1535.04620681504,69,69,36,2.70704890645249,334,167,-1.39333140194207
"Moldovan I.",1456.09700992797,6,1500,0,1500,0,1458.43104365767,6,1500,0,1456.71850958959,6,1455.3835083981,6,1500,0,0,0,0,6,1,-1.75611960288113
"Ascione T.",1378.96978414486,65,1419.55935980215,32,1458.48161403429,4,1429.39339236936,29,1500,0,1404.68418432874,33,1416.06969191485,50,1397.76619180452,15,15,2,-3.1531467545326,50,17,-1.68806187967285
"Bogomolov A.",1508.99941359808,155,1512.9136067283,122,1476.7718076025,23,1418.31843676434,10,1500,0,1436.03002280933,33,1518.16322233049,132,1452.52956702117,23,23,7,-1.67873567724128,132,56,2.03871222116439
"Veronelli D.",1492.53861130236,5,1489.84423467604,1,1500,0,1502.30339107459,4,1500,0,1501.28565701566,4,1490.80156101434,5,1500,0,0,0,0,5,2,-0.298455547905577
"Tenconi T.",1488.16136751458,3,1500,0,1500,0,1486.16556619498,3,1500,0,1484.7795644204,3,1496.98375892613,2,1490.46480379524,1,1,0,-0.328240841324664,2,1,-0.14530445809229
"Almagro N.",1634.23249618333,622,1597.88846820937,200,1494.85542380558,26,1700.48015460735,396,1500,0,1678.29322450774,422,1606.72431160186,514,1652.56019755706,108,108,63,-0.143866596706322,514,305,5.51316644403959
"Ascione A.",1499.40693086104,2,1501.11333282681,2,1500,0,1500,0,1500,0,1500,0,1500.03261165934,2,1500,0,0,0,0,2,1,-0.0237227655584863
"Petzschner P.",1554.22001477909,185,1535.79053752302,109,1567.12893593743,37,1490.20130275035,39,1500,0,1558.93391079607,76,1586.47354269059,150,1490.29546219227,35,35,15,-1.61324602637362,150,71,3.78204661753721
"Iwami T.",1469.86676876395,4,1470.33294532292,4,1500,0,1500,0,1500,0,1500,0,1470.1245784721,4,1500,0,0,0,0,4,1,-1.20532924944209
"Iwabuchi S.",1435.59390238494,13,1434.65865676364,13,1500,0,1500,0,1500,0,1500,0,1433.84769167244,13,1500,0,0,0,0,13,3,-2.57624390460243
"Muller G.",1773.90668510194,314,1709.2273288345,216,1612.98773124083,58,1481.48043302887,40,1500,0,1641.12226440331,98,1770.03818607974,253,1551.20139216008,61,61,27,4.19849628184677,253,130,6.75777112223104
"Hemmes F.",1486.43009720825,4,1504.52914462684,2,1489.99694922962,1,1487.06032439041,1,1500,0,1477.74932125771,2,1483.73019273364,4,1500,0,0,0,0,4,1,-0.542796111670169
"Kucera V.",1514.84434316981,2,1512.04468496686,2,1500,0,1500,0,1500,0,1500,0,1513.74169650278,2,1500,0,0,0,0,2,1,0.593773726792302
"Patience O.",1420.15977187882,78,1418.35093158481,18,1497.7789178627,6,1436.76305901625,54,1500,0,1438.66490668734,60,1427.83098214256,58,1432.47156696379,20,20,6,-0.380804055589398,58,20,-2.81280506925776
"Mayer F.",1661.78605370361,421,1610.37446933833,211,1656.83659019569,52,1546.76778249689,158,1500,0,1655.04207648305,210,1677.94083854074,346,1524.92656307406,75,75,36,1.41431819578634,346,175,5.05712395235777
"Hippensteel K.",1484.93486155859,4,1476.06517518427,4,1500,0,1500,0,1500,0,1500,0,1491.58810547081,3,1486.3691374302,1,1,0,-0.298039620067175,3,1,-0.30456591758904
"Ramirez-Hidalgo R.",1367.88166271545,183,1400.91356213459,36,1419.22844299221,8,1391.21495996822,139,1500,0,1363.21060230251,147,1370.73932141147,158,1387.69776683595,25,25,5,-3.01890759701397,158,57,-2.26582589436806
"Monaco J.",1712.13134211577,564,1640.8143928683,196,1485.2865728025,16,1701.53484330352,352,1500,0,1693.47668584456,368,1725.42189610808,489,1502.11391413717,75,75,31,-11.3611950205301,489,289,19.8464487051612
"Baker B.",1495.75949573324,59,1433.27504296949,39,1515.06621204608,10,1526.37893602602,10,1500,0,1535.78058907002,20,1480.50501568134,40,1482.91501515308,19,19,7,1.17327313199991,40,13,-1.34289330267011
"Cakl T.",1451.11430617131,9,1446.17600003789,7,1500,0,1499.45559394697,2,1500,0,1500.16636643922,2,1450.21446438887,9,1500,0,0,0,0,9,2,-1.95542775314768
"Hernych J.",1574.91752708962,176,1502.66732580327,96,1527.0687953865,40,1456.85693246099,40,1500,0,1528.8985541718,80,1553.7650394233,146,1471.35820280272,30,30,10,-0.198659866214202,146,62,3.19536094979888
"Rocha D.",1499.31015589558,3,1500,0,1500,0,1497.80166701392,3,1500,0,1496.6257596992,3,1499.34827283785,3,1500,0,0,0,0,3,1,-0.0275937641769328
"Robert S.",1536.97428335957,97,1495.35787144816,50,1472.44179808674,9,1502.29693337395,38,1500,0,1504.25326740736,47,1522.3452056728,68,1476.70847746905,29,29,10,1.02344118185268,68,26,0.45553015253015
"Devilder N.",1454.91198193826,68,1439.25657458495,19,1481.99329945153,6,1469.4797834607,43,1500,0,1464.45429541068,49,1412.22268077665,52,1487.64081828714,16,16,6,1.36468782051483,52,17,-3.16820854298424
"Chela J.",1526.14813091902,5,1500,0,1500,0,1520.07977041821,5,1500,0,1520.6403781094,5,1524.60833396465,5,1500,0,0,0,0,5,3,1.04592523676095
"Pashanski B.",1449.49802541282,70,1494.65520413935,16,1468.19066109382,3,1445.50204799701,51,1500,0,1426.7957781692,54,1475.76989639136,61,1431.80890604365,9,9,1,-1.59325518336558,61,22,-0.42682380012153
"Ventura S.",1429.51875085333,97,1407.77172501093,12,1421.76677741473,7,1493.8437158845,78,1500,0,1447.70369871005,85,1463.89328061955,86,1409.07893403848,11,11,1,-3.22840091271538,86,37,0.409150946848705
"Vagnozzi S.",1494.22476748776,11,1500,0,1500,0,1493.02627348127,11,1500,0,1490.67680004708,11,1492.64880208442,11,1500,0,0,0,0,11,4,-0.231009300489556
"Guzman J.P.",1435.24127257706,21,1485.75519811772,3,1486.71667462987,1,1451.07557191677,17,1500,0,1444.79056597453,18,1456.24982576766,18,1464.86883614906,3,3,0,-0.92714624329186,18,6,-1.66320285362591
"Koellerer D.",1466.31544133959,52,1498.99562837537,18,1448.50889241916,4,1478.66029300289,30,1500,0,1442.27027874399,34,1481.92060776156,45,1468.74363306911,7,7,2,-0.830009044438757,45,17,-0.517373301977577
"Haehnel J.",1438.98548313785,23,1523.01711976262,10,1466.40950978924,3,1435.61332828078,10,1500,0,1403.53728997263,13,1461.56209818097,17,1459.50669819675,6,6,1,-1.24795749623592,17,6,-1.19262317825002
"Jeanpierre J.",1522.17096437986,5,1506.08398293749,2,1500,0,1509.82647366621,3,1500,0,1509.6091855355,3,1505.0310166146,2,1508.13512456107,3,3,2,0.663902844441552,2,1,0.222935730752664
"Garcia-Lopez G.",1541.62226504998,564,1501.94842036795,270,1474.32920669503,54,1655.37817725856,240,1500,0,1608.16694311844,294,1537.46823151816,476,1523.05768653159,88,88,39,-2.06001710498507,476,227,3.72490770698409
"Starace P.",1519.89208677222,321,1409.20579641576,79,1405.2853060996,12,1555.5886744536,230,1500,0,1528.95879135544,242,1540.24007238414,279,1367.4977007577,42,42,9,-8.4244231535,279,133,9.22010662438902
"Falla A.",1505.49369303144,246,1489.91941345762,147,1486.30032021712,40,1480.35925900682,59,1500,0,1497.84360641578,99,1519.35520532364,191,1459.59172109661,55,55,21,2.91380588390223,191,71,-2.69405816264453
"Chiudinelli M.",1484.01191928764,116,1455.66521807601,81,1490.11859947647,14,1467.4665790672,21,1500,0,1472.81000081905,35,1469.35948204577,99,1507.68457489617,17,17,8,1.99423324594199,99,32,-2.63375647443656
"Seppi A.",1615.38877311109,578,1559.84155392823,292,1632.87794972057,80,1604.64129753072,206,1500,0,1647.89375788532,286,1580.5374163136,485,1644.9563312808,93,93,45,0.398582920886397,485,237,4.21696800355718
"Marray J.",1473.69414757504,12,1489.89752602008,1,1475.1826463137,11,1500,0,1500,0,1481.63984942325,11,1500.61915785995,9,1471.76422618537,3,3,0,-1.20110691215787,9,4,0.148872815159465
"Whitehouse W.",1490.42398838462,10,1496.65440819971,7,1494.78534297806,3,1500,0,1500,0,1492.39670280743,3,1488.79750057234,10,1500,0,0,0,0,10,4,-0.383040464615368
"Lu Y.H.",1642.78832502798,323,1595.11224901608,242,1553.89016937397,59,1446.85328957472,22,1500,0,1547.43932987064,81,1646.84258241115,259,1464.77090504434,64,64,22,-1.80500957666738,259,111,7.51654257778669
"Ancic I.",1525.53876641441,3,1500,0,1518.76347173794,3,1500,0,1500,0,1520.53957356661,3,1523.72573403921,3,1500,0,0,0,0,3,2,1.02155065657638
"Flanagan I.",1524.47131177376,3,1500,0,1520.87251461716,3,1500,0,1500,0,1522.02825861019,3,1522.13856588847,3,1500,0,0,0,0,3,2,0.978852470950498
"Bracciali D.",1501.05965480231,67,1452.83292275119,30,1514.04769312164,14,1513.27757024734,23,1500,0,1518.14705955137,37,1506.54820090894,51,1449.84127011426,16,16,5,-1.24770567333082,51,21,1.29009186542341
"Pescosolido S.",1463.01346451503,7,1493.76550157946,1,1490.26689943216,3,1470.40279636325,3,1500,0,1460.53888926702,6,1455.94831898114,5,1499.78100167855,2,2,1,0.199293013341357,5,0,-1.67875443274022
"Hilton M.",1479.44522118862,5,1500,0,1465.08228024381,5,1500,0,1500,0,1472.72396217981,5,1490.12179454221,1,1484.87448425136,4,4,1,-0.429972855313844,1,0,-0.392218297141341
"Verdasco M.",1510.98744473702,2,1500,0,1500,0,1504.75647488608,2,1500,0,1508.18906929896,2,1509.6371048252,2,1500,0,0,0,0,2,1,0.439497789480973
"Vassallo-Arguello M.",1427.73835411295,125,1387.30671367295,25,1468.91713783064,7,1497.11815236865,93,1500,0,1493.49356069333,100,1437.50673458491,101,1448.50442382815,24,24,8,-0.0954719717010551,101,39,-2.79499386378107
"Beck A.",1431.15387946766,96,1459.67061209578,34,1517.47987165723,14,1430.20222544635,48,1500,0,1447.40878489821,62,1429.016109786,74,1473.24480132157,22,22,8,-0.0365020468762662,74,29,-2.71734277441743
"Schukin Y.",1502.84185100269,31,1432.26184836929,6,1500,0,1546.10459468618,25,1500,0,1542.41590644713,25,1502.34660426618,28,1487.58529476815,3,3,1,-0.273216455456775,28,11,0.386890495564563
"Minar I.",1486.44414673348,94,1531.82098717388,42,1442.40778683767,13,1448.04438864212,39,1500,0,1422.10084090592,52,1480.97446534355,78,1450.17718858019,16,16,4,-1.34082244099743,78,29,0.798588310336702
"Serra F.",1461.37888135039,275,1441.91482955002,145,1435.58495466135,26,1526.62519782576,104,1500,0,1490.31746241671,130,1467.11825315719,221,1458.12923712107,54,54,20,-0.694263514627644,221,96,-0.850581231356676
"Kubot L.",1513.52215737635,197,1440.63592018258,93,1528.7510833939,23,1514.95757370493,81,1500,0,1541.16435764448,104,1474.86906317767,157,1524.76457908114,40,40,20,4.1858769374453,157,60,-3.64499064239126
"Baghdatis M.",1697.05535655978,503,1681.09697187316,349,1593.20380853166,79,1476.60080069472,75,1500,0,1591.55277038199,154,1667.58025716391,398,1604.35345109568,105,105,61,9.00814945328423,398,212,-1.12593519089302
"Tsonga J.W.",1927.86360782077,515,1872.12414520229,353,1730.12243278578,57,1760.21185583767,105,1500,0,1808.50321323793,162,1863.00662099911,372,1866.44736639924,143,143,108,16.8795643866314,372,243,0.234979926199573
"Lu H.",1504.69105308259,2,1503.84105621469,2,1500,0,1500,0,1500,0,1500,0,1504.3681064777,2,1500,0,0,0,0,2,1,0.187642123303465
"Djokovic N.",2264.28309621124,839,2223.908952033,554,1898.65575383589,79,2127.47526845677,206,1500,0,2154.57081526271,285,2226.54693325892,574,2146.97372442958,265,265,228,16.9571686855119,574,474,13.614155162938
"Boeker M.",1485.59675382689,5,1487.82675607042,4,1500,0,1492.98005124633,1,1500,0,1495.89600956632,1,1492.85988798015,4,1489.60255843613,1,1,0,-0.287194037960703,4,1,-0.288935808963808
"Roger-Vasselin E.",1555.95187745225,207,1560.30616625507,118,1502.07607195664,35,1468.2996482728,54,1500,0,1496.22136071552,89,1529.57906166319,167,1486.12928849512,40,40,15,0.945825415140966,167,69,1.29224968294893
"Zhu B.Q.",1463.40525865654,5,1467.77170989813,5,1500,0,1500,0,1500,0,1500,0,1463.54633012623,5,1500,0,0,0,0,5,1,-1.46378965373846
"van Gemerden M.",1495.81667540501,10,1493.97700863991,3,1501.76234779421,2,1499.23603030867,5,1500,0,1498.60513070845,7,1508.62924909262,6,1480.87080146132,4,4,1,-0.547821065361943,6,3,0.380488081562388
"Wang Y.T.",1503.37417672632,40,1494.47581994511,25,1492.86829814832,12,1467.9746127756,3,1500,0,1474.94066122663,15,1487.95061299855,30,1479.22405674865,10,10,3,0.0947566896515895,30,11,0.0402103794012775
"Monfils G.",1870.65087346176,573,1825.81732656431,357,1592.51632483911,49,1775.8114376231,167,1500,0,1757.73834906291,216,1836.34744399839,453,1761.21571887046,120,120,83,8.64386052697475,453,283,6.18217441149571
"Ryderstedt M.",1485.52585109317,20,1501.16024541025,12,1500,0,1486.60834518531,8,1500,0,1482.07008437494,8,1483.13473460498,20,1500,0,0,0,0,20,8,-0.578965956273127
"Vico U.",1491.96601608906,6,1501.69800593847,4,1492.46448352376,1,1492.08963765833,1,1500,0,1482.29924309629,2,1491.80266084661,6,1500,0,0,0,0,6,2,-0.321359356437488
"Reynolds B.",1438.0773402249,99,1402.64703872894,74,1446.85109073811,17,1493.50533848611,8,1500,0,1463.68339211119,25,1426.67831600535,75,1448.97561401938,24,24,7,0.524845641443972,75,21,-3.00175203244786
"Healey N.",1476.95778143219,18,1470.2339433614,15,1499.78294559373,2,1492.26662162492,1,1500,0,1494.47633116499,3,1455.59075827734,12,1504.18442651376,6,6,3,1.04108218077766,12,3,-1.96277092349025
"Widom T.",1526.16759542597,10,1519.18179147871,10,1500,0,1500,0,1500,0,1500,0,1524.64616254241,10,1500,0,0,0,0,10,5,1.04670381703887
"Sun P.",1461.08392588139,5,1462.25169070017,5,1500,0,1500,0,1500,0,1500,0,1460.45216651231,5,1500,0,0,0,0,5,1,-1.55664296474434
"Gabashvili T.",1520.75133754373,280,1486.55439695182,155,1428.95578101628,22,1525.98484933466,103,1500,0,1503.76120131877,125,1494.01482090371,231,1493.94889320695,49,49,18,1.72402686794859,231,84,-0.893973366199555
"Simon G.",1757.85780103587,640,1728.64271935272,379,1614.78317101005,61,1669.64022667326,200,1500,0,1693.31501311459,261,1739.7483584176,528,1719.98860769715,112,112,71,5.50088884712906,528,312,4.81342319430582
"Luczak A.",1519.70509337163,1,1500,0,1500,0,1519.7025177735,1,1500,0,1519.47253857518,1,1519.81256944186,1,1500,0,0,0,0,1,1,0.788203734865049
"Navarro-Pastor I.",1465.98768557967,99,1421.18062314847,24,1472.44636641866,17,1477.6344080097,58,1500,0,1478.6235372707,75,1470.04624024721,88,1455.59274677369,11,11,2,-1.14973463005601,88,33,-0.210757946757401
"Fogues F.",1500.03151154701,3,1500,0,1500,0,1495.48708876493,3,1500,0,1493.80385902945,3,1497.69140470222,3,1500,0,0,0,0,3,1,0.00126046188059536
"Mertinak M.",1455.32924558426,14,1500,0,1481.57916574244,6,1468.96262045853,8,1500,0,1452.34368565707,14,1460.29230104274,13,1488.31444467312,1,1,0,-0.360575302363347,13,4,-1.42625487426623
"Vik R.",1448.73065098301,46,1473.48312972658,21,1469.51989434631,5,1497.79680358692,20,1500,0,1468.10297123944,25,1463.09392036932,39,1461.65636532031,7,7,1,-1.11513871922893,39,14,-0.935635241450569
"Dlouhy L.",1432.85228521491,57,1416.73051030973,18,1468.31008667406,7,1474.65046669441,32,1500,0,1449.04144835584,39,1419.38264844166,43,1471.42953188089,14,14,5,1.24508924024587,43,11,-3.93099783164958
"Murray A.",2232.95295255721,730,2113.52551637074,496,1935.11593203075,106,1998.41738867684,128,1500,0,2097.88850137341,234,2171.6132124547,517,2023.30592079322,213,213,173,11.7569334716362,517,393,17.5611846306523
"Rettenmaier T.",1507.07104101348,4,1501.7475446878,2,1501.9063754018,2,1500,0,1500,0,1500.04156219789,2,1506.48634864813,4,1500,0,0,0,0,4,2,0.282841640539105
"di Mauro A.",1414.757731617,49,1483.59934501292,4,1486.11059814343,3,1411.43383301164,42,1500,0,1406.05399626448,45,1424.7620896414,41,1458.92728987967,8,8,2,-0.53010418201701,41,12,-2.87958655330301
"Sherwood D.",1505.15350664998,2,1500,0,1500.38395260895,2,1500,0,1500,0,1501.00744733316,2,1500,0,1502.06818214697,2,2,1,0.206140265999011,0,0,0
"Bozoljac I.",1443.01120525021,22,1438.30840573038,8,1478.27260816656,9,1497.38013040308,5,1500,0,1483.65348923083,14,1418.93150712332,13,1509.24751963567,9,9,4,1.20117925395147,13,2,-3.480731043943
"Chadaj A.",1501.03046308811,2,1500,0,1500,0,1501.66751257195,2,1500,0,1500.76043656694,2,1500.32841171547,2,1500,0,0,0,0,2,1,0.0412185235244098
"Jenkins S.",1449.5895682222,20,1444.30147263789,13,1500.51859425698,2,1488.12860163727,5,1500,0,1485.8747145193,7,1467.15242595195,13,1466.2648773767,7,7,1,-0.733767727144818,13,4,-1.28264954396724
"Ram A.",1432.97958852725,9,1433.06291024903,8,1488.3071152272,1,1500,0,1500,0,1492.04209979481,1,1447.99753380766,7,1478.11721504152,2,2,0,-0.632966210565838,7,1,-2.04785024834418
"Capdeville P.",1416.22137152614,102,1452.53631530712,54,1440.05561704693,9,1443.39216152457,39,1500,0,1404.69620189229,48,1416.7093151484,84,1472.83291928451,18,18,7,0.987260040013239,84,28,-4.33840517896764
"Lammer M.",1478.58670060515,19,1505.5204937967,11,1500,0,1445.40716499362,8,1500,0,1445.53222662666,8,1470.31029324697,16,1497.8829509317,3,3,1,0.225606233876559,16,4,-1.08213820967079
"Wang Y. Jr",1499.48592865347,2,1498.57033051615,2,1500,0,1500,0,1500,0,1500,0,1499.49164038736,2,1500,0,0,0,0,2,1,-0.0205628538610786
"Matsui T.",1513.9552849652,4,1509.84675723123,4,1500,0,1500,0,1500,0,1500,0,1513.54981400827,4,1500,0,0,0,0,4,2,0.55821139860812
"Gremelmayr D.",1465.07438089201,83,1440.94713431234,45,1440.01093720864,10,1523.46909312649,28,1500,0,1465.70448649063,38,1488.00833367954,70,1444.11262056112,13,13,3,-1.06251925523723,70,27,-0.334505509082257
"Aldi F.",1449.21267178218,8,1500,0,1500,0,1451.88748807798,8,1500,0,1450.0651226243,8,1449.11176502385,8,1500,0,0,0,0,8,1,-2.03149312871262
"Karanusic R.",1399.0545914608,42,1385.94452674645,23,1484.62177977547,10,1450.91184215237,9,1500,0,1455.73109617299,19,1394.45103356543,26,1444.49664491913,16,16,4,-0.332606784443382,26,5,-3.70520955712469
"Eitzinger R.",1495.4762850501,9,1492.37136235671,3,1500,0,1492.68183934437,6,1500,0,1494.67221719442,6,1494.10791831208,9,1500,0,0,0,0,9,3,-0.180948597996044
"Berrer M.",1476.83000138055,223,1490.93340471335,149,1435.64606044613,24,1445.43958732317,50,1500,0,1440.10936077986,74,1474.57238414243,190,1418.87339776999,33,33,9,-2.9595254229019,190,74,2.03272547812376
"Bopanna R.",1445.48637866298,21,1428.55907872861,13,1485.26949201083,8,1500,0,1500,0,1491.29046936378,8,1439.84209093839,21,1500,0,0,0,0,21,5,-2.18054485348076
"Faurel J.C.",1470.83777819204,9,1488.24333002863,6,1486.46447942316,1,1476.59139620596,2,1500,0,1473.99670226135,3,1471.21781274139,5,1482.77957147352,4,4,1,-0.125311689650256,5,1,-1.04117718266806
"Greul S.",1529.53418959797,112,1481.54691819938,51,1474.00625841875,9,1494.64096655666,52,1500,0,1506.94464274598,61,1545.60198929012,98,1427.92309884406,14,14,2,-2.47197197322666,98,40,3.65333955714557
"Gimeno-Traver D.",1521.09933395627,260,1382.97121032966,66,1376.5326075842,19,1553.33422509171,175,1500,0,1524.60623369598,194,1530.04918766539,224,1382.30427566377,36,36,8,-2.88938182616563,224,87,3.73335518441638
"Marcaccio G.",1497.44978935095,5,1487.47124203382,1,1500,0,1510.28669840613,4,1500,0,1509.02072853738,4,1497.38942759862,5,1500,0,0,0,0,5,2,-0.10200842596217
"Del Potro J.M.",1926.31440301116,436,1905.91932500115,315,1664.70882372834,43,1800.52564448643,78,1500,0,1827.42993592788,121,1897.73056260016,339,1810.688960469,97,97,69,3.86945600800578,339,239,13.1831201124405
"Aguilar J.",1473.7041145568,6,1500,0,1500,0,1471.79436333765,6,1500,0,1472.4883616898,6,1477.62889464616,5,1493.22314637008,1,1,0,-0.136754336038499,5,1,-0.915081081689435
"Korolev E.",1505.89944010211,151,1571.08763980794,84,1428.11680490866,12,1459.34140487111,55,1500,0,1430.22637958821,67,1503.31785131305,128,1476.38058788491,23,23,7,-1.15510806070848,128,59,1.39108566479304
"Warburg S.",1491.07316569361,15,1478.92704598188,14,1489.86864736521,1,1500,0,1500,0,1491.07163345336,1,1478.20219701193,10,1494.78190954961,5,5,2,0.344107234527405,10,3,-0.701180606782997
"Wilson B.",1468.58070916497,5,1475.65523931504,4,1487.5,1,1500,0,1500,0,1487.5698058473,1,1477.53025744301,4,1489.38406886658,1,1,0,-0.374204055671215,4,1,-0.882567577729993
"Ghem A.",1476.69336738702,7,1500,0,1500,0,1479.30828563325,7,1500,0,1476.56611581128,7,1477.45138605928,7,1500,0,0,0,0,7,2,-0.93226530451922
"Meffert D.",1494.69190404832,13,1491.79655659694,7,1493.89378708114,3,1497.04946730264,3,1500,0,1495.81597731706,6,1497.9313411641,12,1489.01536324619,1,1,0,-0.399363072443538,12,5,0.187039234376306
"Klec I.",1467.66723960084,8,1475.04439096085,5,1500,0,1490.9766098209,3,1500,0,1490.74459031706,3,1466.32469974,8,1500,0,0,0,0,8,2,-1.29331041596654
"Al Ghareeb M.",1473.82289493817,7,1475.62843834623,6,1500,0,1493.27694565148,1,1500,0,1493.49966548839,1,1470.92814315587,7,1500,0,0,0,0,7,1,-1.04708420247339
"Querry S.",1472.52961056128,7,1468.62745363906,5,1501.32892266941,2,1500,0,1500,0,1500.37393197596,2,1471.4091725798,7,1500,0,0,0,0,7,2,-1.09881557754874
"Berlocq C.",1596.74877937281,268,1489.4956587511,76,1427.53890044324,19,1630.44570845721,173,1500,0,1617.9107499547,192,1609.97678474862,229,1393.71399186143,39,39,9,-5.99798595733412,229,103,9.86793713224671
"Balleret B.",1494.31417564816,11,1497.45157595714,3,1500,0,1483.19123845967,8,1500,0,1485.5673118498,8,1490.20186336674,11,1500,0,0,0,0,11,3,-0.227432974073609
"Saoudi S.",1490.78937394063,5,1486.30200234685,1,1500,0,1500.13636213262,4,1500,0,1498.63330345125,4,1502.97728542796,4,1486.11677181155,1,1,0,-0.593913027791143,4,2,0.225487985416297
"Tahiri M.",1449.27525564639,7,1500,0,1500,0,1447.272928858,7,1500,0,1445.59304575343,7,1447.9917141661,7,1500,0,0,0,0,7,1,-2.02898977414451
"Chardy J.",1596.42311906478,401,1576.94578106107,214,1523.73837630734,37,1612.21016608201,150,1500,0,1603.89530649854,187,1549.87806526802,322,1661.58621452732,79,79,45,8.40545449800242,322,152,-4.54852973541118
"Gil F.",1553.87407851257,115,1521.58032272392,40,1443.50525071733,8,1546.03317862294,67,1500,0,1517.80115748416,75,1547.49143577703,98,1435.24738399007,17,17,3,-3.15791567403255,98,46,5.31287881453538
"Kindlmann D.",1445.68286132806,12,1478.8130224823,5,1500,0,1448.49864729437,7,1500,0,1449.73693268422,7,1454.86870588924,5,1468.72609829226,7,7,1,-0.469403418140504,5,0,-1.70328212873726
"Montcourt M.",1502.6297172579,15,1471.27992497642,4,1500,0,1510.56144757127,11,1500,0,1513.25587954508,11,1482.85219601513,8,1506.41302166483,7,7,3,0.794869219484938,8,2,-0.689680529169024
"Zverev M.",1611.47651961908,191,1590.90215820854,109,1500.08988471954,34,1401.94995017281,48,1500,0,1448.42056886611,82,1592.78777338423,169,1412.17519643731,22,22,5,-2.6592604746324,169,68,7.11832125939567
"Kunitsyn I.",1418.18331839955,203,1433.81814682772,137,1432.78126200321,37,1434.784791826,29,1500,0,1418.78075982639,66,1425.82604605352,172,1422.61716785803,31,31,8,-2.76269123252791,172,60,-0.509976031489862
"Becker B.",1516.37583801436,358,1504.68127671085,249,1548.4332087917,66,1400.16056597913,43,1500,0,1512.47732503302,109,1505.45533550966,304,1476.4761296154,54,54,19,-0.265053975877651,304,130,0.920087496451947
"Bloomfield R.",1459.43123574025,16,1479.20739309184,2,1457.97718440636,14,1500,0,1500,0,1461.24970224729,14,1467.93097627397,11,1477.52573967273,5,5,1,-0.603568018352689,11,3,-1.01918255203732
"Cilic M.",1928.51338030566,538,1872.01104664337,333,1735.03079823611,67,1711.09579573815,138,1500,0,1781.11501943969,205,1888.50068884186,421,1821.81565141996,117,117,83,11.6130517659848,421,266,5.52748344624168
"Alves T.",1426.9647257303,30,1448.65602942109,15,1488.82278689037,5,1448.34506711456,10,1500,0,1442.78696262448,15,1408.9164373463,21,1495.01929677384,9,9,3,0.891949933621238,21,4,-3.81336090440914
"De Bakker T.",1519.67284711297,131,1493.46329925093,69,1475.63993568673,16,1531.35313061697,46,1500,0,1514.1162815715,62,1529.88908627214,112,1471.46505751442,19,19,6,-1.09636772813714,112,47,1.88328161265578
"Fognini F.",1695.40930806871,453,1625.61570916284,171,1531.00801104916,27,1694.95900811722,255,1500,0,1685.67826135507,282,1689.13692212344,386,1568.13917083674,67,67,32,-0.761686193884294,386,193,8.57805851663264
"Querrey S.",1659.40834224156,483,1608.39583274598,329,1657.60969975101,78,1551.89558962284,76,1500,0,1670.72113716912,154,1643.96324340329,405,1560.1402263374,78,78,39,-2.89891791506953,405,231,9.27525160473208
"Junqueira D.",1420.98627202691,43,1483.17980137688,8,1490.39299303876,1,1418.71096858445,34,1500,0,1411.90094489893,35,1401.53848977204,35,1499.77964186545,8,8,3,0.820077854268304,35,8,-3.98062697319197
"Hartfield D.",1472.7312763689,41,1464.74253125968,7,1473.10672345036,2,1510.59742831723,32,1500,0,1488.73155226521,34,1481.44620423689,35,1475.54901985414,6,6,1,-0.600109012624798,35,14,-0.490639932619321
"Haider-Mauer A.",1499.09315650564,3,1496.0895925537,1,1500,0,1499.46543837898,2,1500,0,1502.37953862663,2,1497.7722291507,3,1500,0,0,0,0,3,1,-0.0362737397744353
"Oudsema S.",1480.94186384101,5,1490.85552685859,4,1489.23657933048,1,1500,0,1500,0,1488.33513087562,1,1480.40984078359,5,1500,0,0,0,0,5,1,-0.762325446359659
"Ianni S.",1504.7488267957,2,1500,0,1500,0,1502.70224541559,2,1500,0,1503.82216343238,2,1501.19722152619,2,1500,0,0,0,0,2,1,0.189953071828174
"Przysiezny M.",1412.50398527018,78,1434.97993290187,42,1464.50935531309,12,1391.24349683975,24,1500,0,1378.70740616421,36,1408.64181929797,63,1447.49371392415,15,15,4,0.125568774765524,63,15,-3.62540936395829
"King P.",1429.76358529407,9,1425.97387525424,9,1500,0,1500,0,1500,0,1500,0,1436.58611639175,8,1487.55843562853,1,1,0,-0.371870544295045,8,1,-2.4375860439423
"Sweeting R.",1557.51517428426,89,1489.23874999636,65,1476.4558527989,10,1542.42988484656,14,1500,0,1536.57146148127,24,1547.85301791221,71,1459.55123594768,18,18,5,-1.14984738771192,71,28,3.45045435908223
"Stoppini A.",1488.84698632697,11,1498.96554984466,9,1500,0,1481.26471346874,2,1500,0,1480.74425324376,2,1489.80454401559,10,1496.90247874886,1,1,0,-0.0614776398837582,10,3,-0.38464290703747
"Hajek J.",1430.45628585002,95,1348.12818238249,45,1464.41696448649,4,1504.65626737803,46,1500,0,1496.80453724764,50,1434.26478688524,75,1442.78381472015,20,20,5,0.239855095494884,75,21,-3.02160366149422
"Gregorc L.",1534.18449287819,13,1526.68624175236,12,1488.77182529634,1,1500,0,1500,0,1496.385349204,1,1535.69464431293,12,1494.25072350045,1,1,0,-0.159241696680376,12,6,1.52662141180795
"Crivoi V.",1418.70666650551,41,1460.32808763097,9,1482.25402581154,3,1435.45152330037,29,1500,0,1426.01505738207,32,1421.73830823449,35,1483.31935276983,6,6,2,-0.328151030776547,35,10,-2.92358230900285
"Ledovskikh M.",1444.43343428602,14,1478.45245481586,8,1460.45194076899,5,1486.24244646599,1,1500,0,1452.98761041084,6,1443.38805874139,14,1500,0,0,0,0,14,3,-2.22266262855933
"Auckland J.",1519.23755587097,3,1519.07229135436,3,1500,0,1500,0,1500,0,1500,0,1516.89356443588,3,1500,0,0,0,0,3,2,0.7695022348388
" Hajek J.",1505.36547548786,2,1500,0,1500,0,1503.86587336244,2,1500,0,1503.54658808744,2,1504.67028339377,2,1500,0,0,0,0,2,1,0.214619019514468
"Naso G.",1437.32802490131,14,1500,0,1500,0,1428.75107309732,14,1500,0,1426.29050526954,14,1437.95852626101,14,1500,0,0,0,0,14,3,-2.50687900394771
"Clemens T.",1517.10556235188,3,1512.48684416552,3,1500,0,1500,0,1500,0,1500,0,1514.76919358481,3,1500,0,0,0,0,3,2,0.684222494075357
"Troicki V.",1709.29695101726,424,1671.72475536727,271,1586.70100736764,50,1620.72085395505,103,1500,0,1644.87139878908,153,1683.85839199986,351,1640.96275002921,73,73,43,3.04549389312481,351,183,5.3263841475656
"Robredo R.",1517.29938334983,3,1513.65076195271,3,1500,0,1500,0,1500,0,1500,0,1515.36553686736,3,1500,0,0,0,0,3,1,0.691975333993047
"Jones A.",1457.5086485983,11,1444.43738776598,11,1500,0,1500,0,1500,0,1500,0,1470.71349747726,5,1471.10784249233,6,6,1,-0.709590304125607,5,1,-0.990063751942266
"Rastogi K.",1474.69340470914,5,1474.1895210151,5,1500,0,1500,0,1500,0,1500,0,1473.21906319112,5,1500,0,0,0,0,5,1,-1.01226381163433
"Sela D.",1544.09338064427,245,1503.15821202002,164,1523.4644104061,47,1398.09597541869,34,1500,0,1502.61660135391,81,1538.32988749064,191,1459.30191071732,54,54,19,0.750902756467973,191,82,1.01283246930275
"Smeets R.",1458.66916946581,9,1457.74621593902,8,1500,0,1492.74563063463,1,1500,0,1494.95950872789,1,1461.30750381776,4,1482.33679587846,5,5,1,-0.156363173526746,4,0,-1.49687004784104
"Kuznetsov A.",1428.33335194511,26,1398.69059466887,19,1490.41006649229,5,1497.90560910026,2,1500,0,1500.14608028248,7,1432.8278260645,20,1472.09052925996,6,6,1,-0.197858738043698,20,5,-2.66880718415196
"Levine J.",1488.49276586899,93,1461.31398260399,63,1475.58476734807,23,1449.47516987031,7,1500,0,1455.8564696013,30,1452.88996172732,70,1490.07671907271,23,23,9,2.0785562736983,70,21,-2.53884563893873
"Haase R.",1586.34521108727,312,1498.25960142253,153,1502.77067030724,34,1569.90594171566,125,1500,0,1590.11578557383,159,1590.94104159978,266,1468.70507099969,46,46,15,-1.07110636877296,266,123,4.52491481226382
"Bolelli S.",1616.66974957228,232,1521.57819033764,108,1543.05025892966,27,1609.90519779119,97,1500,0,1636.02130559137,124,1597.98305643586,182,1539.55523145507,50,50,22,4.56506899088418,182,74,0.10172099200688
"Granollers M.",1636.04282980646,392,1585.88257504706,170,1479.9184251244,27,1573.56265007513,195,1500,0,1580.25188592816,222,1577.09002260894,320,1609.1440458475,72,72,35,4.39286194858512,320,149,1.04885124367323
"Andujar P.",1534.29626427178,285,1424.91061766021,102,1403.70655249527,16,1616.98266196687,167,1500,0,1604.40417184375,183,1526.11666918745,244,1465.62596382846,41,41,14,-1.43691215720408,244,102,2.80876272807509
"Gensse A.",1492.14192161008,4,1494.52045490485,1,1500,0,1495.57416805506,3,1500,0,1495.0283732267,3,1500.11241161465,2,1483.71186418489,2,2,0,-0.314728590806272,2,1,0.000405455209550265
"Stepanek M.",1511.66007409671,2,1500,0,1500,0,1506.6591742103,2,1500,0,1506.12144255323,2,1511.08884456002,2,1500,0,0,0,0,2,1,0.46640296386851
"Lorenzi P.",1596.74752763202,183,1517.45774682213,73,1401.29276319474,17,1568.40640761602,93,1500,0,1523.138723831,110,1586.29086843595,157,1404.44673030921,26,26,4,-2.64340418165143,157,63,6.51330528693244
"Brands D.",1536.74144399391,143,1514.01738474016,75,1494.7171821356,15,1521.67251444947,53,1500,0,1516.68269235985,68,1545.82674046373,119,1453.48681765176,24,24,7,-0.824730474802199,119,49,2.29438823455842
"Bachinger M.",1498.20812081126,69,1478.58957053806,36,1467.91159675916,8,1461.85311969494,25,1500,0,1449.80488766458,33,1490.30017353582,59,1456.77588542929,10,10,2,-0.876421230516828,59,21,0.804746062967214
"Summerer T.",1448.70425356722,9,1486.9091540602,2,1491.45831777655,1,1463.34279913903,6,1500,0,1460.44018787822,7,1457.13781793815,7,1476.71410390468,2,2,0,-0.425286789630687,7,1,-1.62654306768052
"Economidis K.",1411.69944993054,12,1437.83359989819,6,1467.47961870918,3,1496.13672407506,3,1500,0,1461.25539137914,6,1418.59106156588,7,1475.98176886043,5,5,1,-0.36742927619302,7,0,-3.16459272658542
"Gulbis E.",1576.23679354339,382,1553.91622238754,235,1469.68852267332,29,1634.23513153543,118,1500,0,1602.01118761322,147,1547.51105919268,315,1545.7144061227,67,67,31,-0.188060074114167,315,159,3.23753181584962
"Recouderc L.",1441.84280569338,15,1440.93305617878,8,1500,0,1483.15537826401,7,1500,0,1486.13181724629,7,1447.77895291904,10,1476.13326149993,5,5,1,-0.341594603205897,10,2,-1.9846931690589
"Brzezicki J.P.",1453.28526485323,23,1465.30206892742,3,1500,0,1481.37123001217,20,1500,0,1479.00709281623,20,1458.24301616499,17,1482.69703197264,6,6,2,-0.01830506780636,17,5,-1.85028433806459
"Cipolla F.",1453.75379229945,101,1468.81952281971,55,1438.07957670332,8,1451.86397449263,38,1500,0,1429.3509673822,46,1455.70994798169,82,1479.11324847492,19,19,7,0.64360679449876,82,28,-2.49345510252069
"Qureshi A.",1504.9770058421,10,1487.86853037562,1,1504.78634002148,9,1500,0,1500,0,1509.5842036629,9,1498.33851454785,8,1506.30372564883,2,2,1,0.144921380230394,8,3,0.0541588534537185
"Stadler S.",1508.14985628097,16,1498.21227709596,8,1487.95484558758,8,1500,0,1500,0,1495.3988564324,8,1497.49243449944,11,1495.26855123698,5,5,2,0.387355184808428,11,4,-0.061360933569761
"Baker J.",1419.319377717,19,1479.94580747419,2,1413.10625937158,17,1500,0,1500,0,1417.684781137,17,1461.5672032938,12,1424.57179785128,7,7,0,-2.16827391481261,12,3,-1.05895097650724
"Guccione A.",1492.8353451082,3,1500,0,1495.5849518306,2,1486.88701503109,1,1500,0,1491.7760659105,3,1486.50442773053,1,1505.09766198742,2,2,1,0.309659372940341,1,0,-0.596245568612521
"Darcis S.",1579.02652711186,159,1556.26175656489,84,1530.71072637722,21,1500.76260995118,54,1500,0,1532.53626638403,75,1573.30030650495,123,1487.31910086647,36,36,12,-0.586152798101327,123,58,3.7472138825757
"Nishikori K.",1976.85487505372,412,1914.92892325407,288,1629.21516605547,41,1872.11119110751,83,1500,0,1889.65244336787,124,1942.60378766426,324,1814.12230366908,88,88,60,4.36488311033124,324,216,14.7093118918177
"Riba P.",1395.19668262479,84,1396.08620188887,20,1452.34179623193,4,1442.33984185659,60,1500,0,1422.19101657947,64,1408.18876223419,69,1439.40060772443,15,15,4,-0.581054558717703,69,20,-3.61107813629055
"Klizan M.",1616.16289582414,189,1561.3804368337,98,1464.38026662153,13,1642.42125132034,78,1500,0,1616.76032009562,91,1640.34931256336,155,1495.46378651258,34,34,14,-0.168162656113229,155,77,4.81467848907883
"Isner J.",1822.61764663763,488,1814.80441135045,353,1619.17796824414,46,1637.87337754742,89,1500,0,1663.20027370451,135,1796.81783924894,399,1706.09564383486,89,89,55,-0.953988793524375,399,250,13.8586946590297
"Odesnik W.",1519.33772500382,97,1464.77997942636,61,1443.1811974475,5,1589.5572790125,31,1500,0,1542.97255633141,36,1554.42217086632,76,1422.63380052976,21,21,5,-2.21940933949237,76,35,2.99291833964504
"Young D.",1618.54805975193,246,1598.72330363454,190,1449.57971470375,29,1437.75991542463,27,1500,0,1458.07586114209,56,1599.8580839583,199,1484.06619985076,47,47,17,1.3301971757018,199,79,3.41172521437558
"Lindahl N.",1451.10112256614,9,1453.98275944167,8,1500,0,1488.84557317082,1,1500,0,1489.52074458066,1,1460.33727208062,7,1483.61402610866,2,2,0,-0.560180603671752,7,1,-1.39577449368261
"fnisk",1517.10328735953,1,1515.23056436418,1,1500,0,1500,0,1500,0,1500,0,1517.07638911694,1,1500,0,0,0,0,1,1,0.684131494381024
"Prpic F.",1453.85352413701,10,1489.29666995926,5,1500,0,1446.55022471411,5,1500,0,1446.90252089443,5,1452.85091174459,10,1500,0,0,0,0,10,2,-1.84585903451971
"Zovko L.",1474.29863340553,5,1489.95710489462,3,1500,0,1481.16254059796,2,1500,0,1480.18384487762,2,1474.23636008456,5,1500,0,0,0,0,5,1,-1.02805466377892
"Kudryavtsev A.",1467.43985778541,18,1476.99019957034,15,1479.01459187872,2,1486.71538467027,1,1500,0,1470.79828750905,3,1480.44717194623,13,1470.48314593286,5,5,1,-0.606688820955195,13,4,-0.695716867628366
"Istomin D.",1553.69547104668,354,1509.52211027573,218,1586.96368282856,56,1519.29682032074,80,1500,0,1587.96111202475,136,1524.09943854201,291,1562.7479457713,63,63,30,5.83194433203814,291,131,-3.68412549017093
"Cuevas P.",1672.88240503647,262,1523.36071193001,91,1505.0423160182,13,1751.52282811297,158,1500,0,1726.23667034033,171,1678.92706302132,227,1473.20956670515,35,35,12,-5.34136039500523,227,123,12.2566565964642
"Marrero D.",1467.04636487912,9,1500,0,1500,0,1469.18445665775,9,1500,0,1467.74777214221,9,1461.68931445607,7,1506.02886456236,2,2,1,0.362647389776914,7,2,-1.68079279461199
"Schwank E.",1514.3318916112,97,1457.88544712771,27,1442.1783386949,8,1537.30924644332,62,1500,0,1517.40685320531,70,1475.96612486756,80,1493.71781705303,17,17,6,0.780192857264291,80,31,-0.206917192816101
"Decoud S.",1523.48829208611,8,1500,0,1488.74967988304,1,1537.87575436334,7,1500,0,1522.17669487405,8,1516.98585288486,6,1498.96044925604,2,2,1,0.432083927337138,6,3,0.507447756107199
"Bellucci T.",1622.90049762247,337,1564.13637368981,143,1483.8801258322,15,1609.23615176333,179,1500,0,1595.6460433897,194,1619.85012827023,284,1496.08330291675,53,53,22,-2.05799924445314,284,141,6.9740191493521
"Anderson K.",1718.71055864396,408,1700.04214890103,283,1610.99868612782,47,1622.00911109597,78,1500,0,1675.6935201506,125,1703.05465266757,333,1686.03306984095,75,75,44,2.47743394134344,333,186,6.27098840441497
"Giraldo S.",1537.70063183147,306,1495.58717715882,138,1476.38427196074,28,1556.87357946784,140,1500,0,1537.11593305181,168,1551.22926324303,264,1417.87656174191,42,42,12,-5.35975688855217,264,123,6.86778216181083
"Sousa J.",1633.54358453616,215,1585.48729357873,116,1500.74918474657,18,1614.50924808411,81,1500,0,1611.98221026144,99,1596.57078581643,185,1578.59578822607,30,30,15,3.66426515725244,185,85,1.67747822419391
"Machado R.",1400.78888923289,50,1430.46690483234,11,1487.44960714854,1,1426.7363891325,38,1500,0,1420.03289150202,39,1422.36101312362,38,1429.7815185279,12,12,2,-1.32942154505582,38,11,-2.63902288562854
"Harrison R.",1617.55436613594,174,1608.71800587919,131,1467.28314294899,27,1455.88464373396,16,1500,0,1456.66454787978,43,1590.89224898777,146,1474.03732225768,28,28,8,0.532814991704034,146,64,4.16935965373343
"Trujillo G.",1506.73963688341,2,1500,0,1500,0,1508.29535794729,2,1500,0,1508.24496797913,2,1506.22191047535,2,1500,0,0,0,0,2,1,0.269585475336521
"Kukushkin M.",1547.00570483335,203,1552.78606302543,131,1461.08834334323,18,1455.38150695723,54,1500,0,1461.34928862711,72,1534.62087982497,167,1488.07661054624,36,36,14,1.37832315330228,167,69,0.501905040031862
"Del Potro J.",1523.02414379337,3,1500,0,1500,0,1518.60412202292,3,1500,0,1521.23590733345,3,1522.74396899295,3,1500,0,0,0,0,3,2,0.920965751734729
"Sidorenko A.",1488.19440416763,13,1482.7356735363,6,1500,0,1498.92952104112,7,1500,0,1498.51080458819,7,1498.18911362381,11,1481.77917781325,2,2,0,-0.89690401802539,11,5,0.424680184730761
"Ouahab L.",1474.87998492011,13,1478.20451525522,2,1500,0,1488.28827229568,11,1500,0,1487.34815688168,11,1481.00067572066,12,1487.99836581766,1,1,0,-0.506350697541748,12,4,-0.498449905653701
"Kavcic B.",1490.46332069832,105,1515.03411071655,46,1411.52512296042,11,1476.19890850587,48,1500,0,1440.85006599398,59,1448.92552899025,75,1511.38105676114,30,30,12,2.77418839465854,75,25,-3.15565556672576
"Lopez-Jaen M.A.",1507.82208819939,3,1500,0,1500,0,1504.26195332928,3,1500,0,1504.22584539956,3,1494.76079668592,1,1508.60420408552,2,2,1,0.536153419748657,1,0,-0.22326989177289
"Gonzalez M.",1418.235021282,84,1427.95728209517,16,1460.28528383485,4,1449.07553218549,64,1500,0,1431.82732511377,68,1435.61186482407,65,1441.72674640523,19,19,5,-1.00680543847254,65,22,-2.26379371024736
"Dell'Acqua M.",1476.90136558024,6,1478.66817811552,2,1500.21957496554,2,1484.77064897798,2,1500,0,1495.79041867058,4,1476.28720026105,6,1500,0,0,0,0,6,1,-0.923945376790359
"Groth S.",1523.15856514892,88,1450.25872389511,56,1532.06765022667,23,1499.54497232148,9,1500,0,1552.0449186967,32,1488.41064048521,70,1521.31505597752,18,18,7,1.95371197597586,70,27,-1.02736937001891
"Eaton C.",1504.03272531928,2,1500,0,1502.9889773779,2,1500,0,1500,0,1500.00992150027,2,1500,0,1501.3431022292,2,2,1,0.161309012771389,0,0,0
"Eleskovic E.",1467.78901141858,10,1458.73884097616,4,1500,0,1497.59978771316,6,1500,0,1496.15885424074,6,1466.72549131926,10,1500,0,0,0,0,10,2,-1.28843954325685
"Bohli S.",1405.05422968806,16,1428.02011696959,9,1487.5,1,1463.39950859152,6,1500,0,1452.02227540427,7,1410.30375655547,15,1483.05375829717,1,1,0,-0.54645110387011,15,1,-3.25137970860742
"Evans B.",1452.74046745438,21,1413.39380741968,14,1512.30427103458,7,1500,0,1500,0,1517.29795061263,7,1461.83637853475,17,1476.01397971332,4,4,1,-0.63112581114809,17,5,-1.25925549067685
"Qureshi A.U.H.",1483.05376108558,5,1474.89244521721,3,1501.51120792203,2,1500,0,1500,0,1498.58830765892,2,1488.17120529946,4,1491.43593276833,1,1,0,-0.258967276094141,4,1,-0.418882280482461
"Rosol L.",1570.91133347751,242,1551.48893580079,137,1473.9586353744,18,1569.72604775908,87,1500,0,1546.72255798304,105,1556.84381068417,205,1502.62486542438,37,37,15,-0.104888781225191,205,89,2.94134212032554
"Dabul B.",1460.60487909352,42,1482.37594850169,15,1491.39998047154,7,1458.69263342268,20,1500,0,1460.64573953653,27,1481.15388981614,34,1447.14918718518,8,8,1,-1.36590246632968,34,14,-0.209902369929578
"Huta Galung J.",1405.72676608032,30,1414.83940575183,17,1468.70123428279,8,1472.6980979705,5,1500,0,1460.16643288957,13,1428.56034952026,25,1440.90532658927,5,5,0,-1.85564355330445,25,5,-1.91528580348284
"Jun W.S.",1455.77722781639,7,1478.32832481632,5,1486.59341631322,1,1486.83284669649,1,1500,0,1472.65947470686,2,1458.7730281966,7,1500,0,0,0,0,7,1,-1.76891088734442
"Mayer L.",1591.44156570253,248,1530.82458675402,105,1510.89631675204,28,1600.8837696972,115,1500,0,1596.64228996245,143,1585.61760185743,194,1571.00472506547,54,54,26,5.16332245958339,194,89,-1.50565983148238
"Devvarman S.",1477.21996565341,114,1515.14883842993,85,1464.85572808951,10,1464.51926667088,19,1500,0,1440.25615593127,29,1499.55188865377,95,1443.22437618645,19,19,5,-3.0513264969945,95,43,2.14012512313099
"Golubev A.",1466.13453936264,151,1447.93653677802,91,1421.45469123313,11,1483.59564426515,49,1500,0,1465.78445496707,60,1467.52340936387,127,1423.91320894593,24,24,4,-1.30943130611811,127,42,-0.0451871193762138
"De Heart R.",1503.91207724831,3,1503.20708257513,3,1500,0,1500,0,1500,0,1500,0,1490.11286782222,1,1511.06236622985,2,2,1,0.565873337763083,1,0,-0.40939024783069
"Cruciat A.",1487.38649236846,3,1500,0,1500,0,1489.51690889482,3,1500,0,1487.47081603147,3,1488.89521084878,3,1500,0,0,0,0,3,1,-0.504540305261697
"Scherrer J.C.",1468.45486800895,5,1487.35288966281,3,1474.3016196171,2,1500,0,1500,0,1477.51257030349,2,1466.85930761961,5,1500,0,0,0,0,5,1,-1.26180527964208
"Soeda G.",1483.13492361868,98,1466.6570460009,75,1452.09382567644,15,1449.76717043023,8,1500,0,1434.12876474982,23,1476.72328425191,78,1447.82760574543,20,20,4,-0.900127313312379,78,24,0.225524258059519
"Jouan R.",1494.47963925043,5,1493.87608600065,4,1500,0,1493.33117058916,1,1500,0,1495.97755067573,1,1496.89814406807,3,1491.63973275579,2,2,0,-0.18275116354641,3,1,-0.0380632664363509
"Mannarino A.",1601.10530596719,238,1552.48451105055,149,1580.21231912006,47,1485.36509066732,42,1500,0,1595.40049170492,89,1587.17734679343,193,1521.7996835223,45,45,18,2.41360095787724,193,85,1.63061128081024
"De Voest R.",1430.53224566001,28,1431.92377989395,22,1462.41177779363,6,1500,0,1500,0,1467.53779158417,6,1446.41677033426,22,1463.65893912869,6,6,1,-0.949043600917276,22,6,-1.82966657268238
"Slanar M.",1493.21321624905,3,1491.9142532384,3,1500,0,1500,0,1500,0,1500,0,1503.82391739429,2,1487.71366630582,1,1,0,-0.455168494255135,2,1,0.18369714421731
"Stakhovsky S.",1552.12331508882,287,1550.97097762983,179,1525.25187340867,43,1455.43049151041,65,1500,0,1511.71799852381,108,1527.01114909355,236,1512.7332445311,51,51,20,-0.0783241733323115,236,102,2.16325677688506
"Tomic B.",1692.6477738696,276,1676.47599004716,182,1607.82282136837,43,1499.94689639727,51,1500,0,1616.47904421694,94,1671.07644443784,212,1654.75054101923,64,64,37,8.65850996693587,212,105,-0.952599012151953
"Klein B.",1476.20078660116,9,1490.71116287865,4,1474.53852008935,5,1500,0,1500,0,1474.79089146308,5,1486.64402823646,4,1469.28399299545,5,5,1,-0.583051936156816,4,1,-0.368916599796666
"De Chaunac S.",1527.89041410317,10,1524.45340396255,10,1500,0,1500,0,1500,0,1500,0,1520.16607474567,8,1504.54051940437,2,2,1,0.403196977979221,8,4,0.712419586147421
"Klaasen R.",1502.09917445972,8,1488.01415034749,5,1513.56982216464,3,1500,0,1500,0,1512.32060743902,3,1503.46107056106,8,1500,0,0,0,0,8,4,0.0839669783888761
"Van der Merwe I.",1489.088767167,3,1500.28774558948,2,1487.915951986,1,1500,0,1500,0,1486.47771119846,1,1498.97282306106,2,1486.82003328091,1,1,0,-0.446290382481703,2,1,0.00984106916170557
"Dimitrov G.",1815.0636478797,338,1798.87816016908,215,1618.65429896541,45,1691.69558851725,78,1500,0,1709.32788301876,123,1788.35504520818,280,1658.14041788335,58,58,33,-1.4266870628575,280,166,14.0292329780453
"Ferreiro F.",1489.81838978599,6,1500,0,1500,0,1490.54497171292,6,1500,0,1490.44598144929,6,1499.1933593061,5,1490.13007692386,1,1,0,-0.306814950610909,5,2,-0.10044945794948
"Ouanna J.",1498.05273301256,22,1478.18811732688,11,1500,0,1484.35609669396,11,1500,0,1489.6516283402,11,1466.68305778159,13,1512.31482930074,9,9,4,1.22184736766348,13,3,-1.29973804716102
"Rufin G.",1530.10726229633,43,1523.55220803487,20,1480.19868365492,6,1480.9943186746,17,1500,0,1484.49518099042,23,1496.40723500451,25,1493.232064574,18,18,7,1.50342751892906,25,9,-0.29913702707599
"Lacko L.",1495.58441152696,164,1468.74760623495,118,1475.27147368313,30,1429.9582088037,16,1500,0,1466.04208854298,46,1495.91166228168,125,1451.36266469425,39,39,11,-1.26723330931373,125,50,1.09060977039199
"Ward J.",1426.02703583056,59,1433.22879510264,17,1417.51914243963,36,1454.33349648622,6,1500,0,1411.84142812216,42,1414.70607656786,45,1451.74167511994,14,14,3,-0.489627448394397,45,12,-2.46929111838308
"Goodall J.",1421.58654638695,12,1489.43569815194,1,1418.56015598431,11,1500,0,1500,0,1418.96437618013,11,1470.84368180897,6,1431.07519831787,6,6,0,-2.26826903904119,6,1,-0.868269105480655
"Ball C.",1491.88900939574,20,1513.94089743599,16,1474.63492840817,2,1479.54635198389,2,1500,0,1455.4132077744,4,1540.69082812704,9,1440.18943974989,11,11,2,-2.25805458151287,9,5,1.93361495734256
"Polansky P.",1457.70272430828,27,1471.66110060447,19,1487.58850094994,1,1461.1474941217,7,1500,0,1450.73351079294,8,1457.42189655498,21,1469.79124643479,6,6,1,-0.280736088766919,21,5,-1.41115493890187
"Ilhan M.",1437.08072486953,70,1427.63634425183,41,1475.83644797666,9,1442.81607838732,20,1500,0,1443.86007810755,29,1405.2527941629,51,1492.12043151178,19,19,7,1.65503179679031,51,12,-4.17180280200893
"Witten J.",1480.41051769605,10,1492.03578743833,7,1492.05091392779,1,1476.78492977096,2,1500,0,1472.13598991736,3,1462.80630669269,4,1491.94964328826,6,6,2,0.511327539855118,4,0,-1.29490683201298
"Zeballos H.",1503.25050946904,151,1502.21374250255,59,1422.60287064389,9,1474.95623461435,83,1500,0,1436.80871262612,92,1508.43224248348,130,1419.01638019814,21,21,5,-2.32546957556855,130,52,2.45548995433014
"Copil M.",1557.73741661171,45,1555.25047740961,22,1485.21780492947,7,1466.32466111597,16,1500,0,1472.42869979358,23,1542.13237905505,42,1492.70308690845,3,3,1,0.234651251937243,42,17,2.07484541253107
"Zeng S.X.",1479.85917275904,6,1471.15747673073,6,1500,0,1500,0,1500,0,1500,0,1474.67635265195,6,1500,0,0,0,0,6,1,-0.80563308963844
"Marchenko I.",1524.4334839869,112,1541.7854119396,80,1453.12567571374,17,1432.54255364646,15,1500,0,1414.73651770815,32,1490.93862848438,89,1482.47818042909,23,23,8,0.85519620509717,89,37,0.122143154378661
"Guez D.",1423.60336149326,17,1429.630348105,14,1500,0,1474.09928917512,3,1500,0,1475.56426779841,3,1437.55515947046,13,1464.12298161046,4,4,0,-0.697711984009075,13,2,-2.35815355626056
"Dolgopolov O.",1629.29176698447,351,1603.77164954646,214,1567.90708850824,39,1619.72049014865,98,1500,0,1640.71060902322,137,1640.78299407544,299,1542.07020078616,52,52,27,-0.214014434024997,299,156,5.38568511340384
"Elgin M.",1463.42157179784,7,1455.83428896131,7,1500,0,1500,0,1500,0,1500,0,1460.5785847507,7,1500,0,0,0,0,7,1,-1.46313712808654
"Serra F. ",1500,2,1500,2,1500,0,1500,0,1500,0,1500,0,1500,2,1500,0,0,0,0,2,1,0
"Seppi A. ",1500,2,1500,2,1500,0,1500,0,1500,0,1500,0,1500,2,1500,0,0,0,0,2,1,0
"Federer R. ",1537.5,5,1537.5,5,1500,0,1500,0,1500,0,1500,0,1537.5,5,1500,0,0,0,0,5,4,1.5
"Stepanek R. ",1525,4,1525,4,1500,0,1500,0,1500,0,1500,0,1525,4,1500,0,0,0,0,4,3,1
"Hernych J. ",1500,2,1500,2,1500,0,1500,0,1500,0,1500,0,1500,2,1500,0,0,0,0,2,1,0
"Chiudinelli M. ",1525,4,1525,4,1500,0,1500,0,1500,0,1500,0,1525,4,1500,0,0,0,0,4,3,1
"Korolev E. ",1512.5,3,1512.5,3,1500,0,1500,0,1500,0,1500,0,1512.5,3,1500,0,0,0,0,3,2,0.5
"Troicki V. ",1500,2,1500,2,1500,0,1500,0,1500,0,1500,0,1500,2,1500,0,0,0,0,2,1,0
"Djokovic N. ",1562.5,5,1562.5,5,1500,0,1500,0,1500,0,1500,0,1562.5,5,1500,0,0,0,0,5,5,2.5
"Nieminen J. ",1500,2,1500,2,1500,0,1500,0,1500,0,1500,0,1500,2,1500,0,0,0,0,2,1,0
"Lammer M. ",1500,2,1500,2,1500,0,1500,0,1500,0,1500,0,1500,2,1500,0,0,0,0,2,1,0
"Cilic M. ",1512.5,3,1512.5,3,1500,0,1500,0,1500,0,1500,0,1512.5,3,1500,0,0,0,0,3,2,0.5
"Gasquet R. ",1512.5,3,1512.5,3,1500,0,1500,0,1500,0,1500,0,1512.5,3,1500,0,0,0,0,3,2,0.5
"Chardy J. ",1500,2,1500,2,1500,0,1500,0,1500,0,1500,0,1500,2,1500,0,0,0,0,2,1,0
"Wawrinka S. ",1512.5,3,1512.5,3,1500,0,1500,0,1500,0,1500,0,1512.5,3,1500,0,0,0,0,3,2,0.5
"Isner J. ",1500,2,1500,2,1500,0,1500,0,1500,0,1500,0,1500,2,1500,0,0,0,0,2,1,0
"Montanes A. ",1500.44952970932,2,1500.44952970932,2,1500,0,1500,0,1500,0,1500,0,1500.44952970932,2,1500,0,0,0,0,2,1,0.0179811883727652
"Berdych T. ",1500,2,1500,2,1500,0,1500,0,1500,0,1500,0,1500,2,1500,0,0,0,0,2,1,0
"Garcia-Lopez G. ",1512.5,3,1512.5,3,1500,0,1500,0,1500,0,1500,0,1512.5,3,1500,0,0,0,0,3,2,0.5
"Davydenko N. ",1525,4,1525,4,1500,0,1500,0,1500,0,1500,0,1525,4,1500,0,0,0,0,4,3,1
"Simon G. ",1512.5,3,1512.5,3,1500,0,1500,0,1500,0,1500,0,1512.5,3,1500,0,0,0,0,3,2,0.5
"Monfils G. ",1500,2,1500,2,1500,0,1500,0,1500,0,1500,0,1500,2,1500,0,0,0,0,2,1,0
"Monaco J. ",1500,2,1500,2,1500,0,1500,0,1500,0,1500,0,1500,2,1500,0,0,0,0,2,1,0
"Ferrer D. ",1512.5,1,1512.5,1,1500,0,1500,0,1500,0,1500,0,1512.5,1,1500,0,0,0,0,1,1,0.5
"Mayer L. ",1500,2,1500,2,1500,0,1500,0,1500,0,1500,0,1500,2,1500,0,0,0,0,2,1,0
"Cuevas P. ",1500,2,1500,2,1500,0,1500,0,1500,0,1500,0,1500,2,1500,0,0,0,0,2,1,0
"Murray A. ",1562.08223466146,5,1562.08223466146,5,1500,0,1500,0,1500,0,1500,0,1562.08223466146,5,1500,0,0,0,0,5,5,2.48328938645824
"Robredo T. ",1512.5,3,1512.5,3,1500,0,1500,0,1500,0,1500,0,1512.5,3,1500,0,0,0,0,3,2,0.5
"Youzhny M. ",1537.48440875157,5,1537.48440875157,5,1500,0,1500,0,1500,0,1500,0,1537.48440875157,5,1500,0,0,0,0,5,4,1.49937635006271
"Tipsarevic J. ",1500,2,1500,2,1500,0,1500,0,1500,0,1500,0,1500,2,1500,0,0,0,0,2,1,0
"Lopez F. ",1500,2,1500,2,1500,0,1500,0,1500,0,1500,0,1500,2,1500,0,0,0,0,2,1,0
"Verdasco F. ",1524.98382687766,4,1524.98382687766,4,1500,0,1500,0,1500,0,1500,0,1524.98382687766,4,1500,0,0,0,0,4,3,0.999353075106284
"Ebden M.",1380.35179318934,113,1406.43902733109,81,1441.59480959329,20,1412.45816848492,12,1500,0,1395.89231151116,32,1369.13920513506,93,1433.69793928803,20,20,5,-1.12519837245445,93,31,-3.66072989997201
"Statham J.",1474.90928797968,5,1465.13675671109,5,1500,0,1500,0,1500,0,1500,0,1474.89253130779,5,1500,0,0,0,0,5,1,-1.00362848081276
"Sorensen L.",1489.38243316635,6,1479.92242105854,4,1500,0,1501.91654081052,2,1500,0,1504.8248193555,2,1495.03816154138,3,1485.7654064427,3,3,1,-0.262456236329391,3,1,-0.16224643701665
"Sergeyev I.",1510.93486485843,2,1508.84380275252,2,1500,0,1500,0,1500,0,1500,0,1500,0,1507.64632582546,2,2,1,0.437394594337013,0,0,0
"Veic A.",1435.29732874243,29,1459.00667653375,11,1500,0,1455.08989822115,18,1500,0,1451.39774524255,18,1402.47994993843,24,1533.8251308836,5,5,3,1.90309321171971,24,5,-4.49120006202266
"Dodig I.",1512.2523682178,237,1477.6302272816,154,1564.39443642861,30,1556.27620453052,53,1500,0,1589.70638621188,83,1535.8206102883,198,1498.29449958049,39,39,15,-2.33158146535315,198,95,2.82167619406514
"Brown D.",1661.48203373796,121,1529.20429219821,49,1531.60408615831,32,1545.50999756164,40,1500,0,1602.55854424204,72,1639.30748175734,99,1478.69988037404,22,22,7,0.304999970621011,99,43,6.15428137889744
"Van Der Merwe I.",1532.54119330971,10,1507.48750609261,7,1512.29195277495,3,1500,0,1500,0,1516.18748365494,3,1531.98145538819,10,1500,0,0,0,0,10,6,1.30164773238857
"Souza J.",1419.54957223089,68,1450.66756664431,8,1486.85807641962,1,1430.1954423434,59,1500,0,1421.66567756733,60,1439.18794133983,61,1425.42469235444,7,7,0,-2.38027006920111,61,24,-0.83774704156334
"Jelenic P.",1498.97681642805,2,1499.14251770129,2,1500,0,1500,0,1500,0,1500,0,1498.61563260323,2,1500,0,0,0,0,2,1,-0.0409273428779701
"Sijsling I.",1440.54000189397,133,1439.85666579524,77,1488.00036838941,23,1448.20966067437,33,1500,0,1454.45083312033,56,1457.56676292204,112,1425.63696890003,21,21,5,-2.39460458341463,112,42,0.0162046591733561
"Berankis R.",1529.62791407349,132,1573.6618842096,99,1413.1415398538,13,1425.21634718153,20,1500,0,1379.91410940264,33,1529.19812164257,106,1484.29262854903,26,26,10,0.790392778069483,106,47,0.394723784870034
"Mertens Y.",1486.07506306471,3,1487.02925390001,3,1500,0,1500,0,1500,0,1500,0,1484.78953491538,3,1500,0,0,0,0,3,1,-0.556997477411573
"Matosevic M.",1518.34832881121,154,1551.50999087204,109,1482.39324768041,19,1463.09708458764,26,1500,0,1479.2144553138,45,1524.19381866469,133,1430.75193246269,21,21,3,-3.71050712310155,133,58,4.44444027554999
"El Amrani R.",1471.38519319134,7,1487.47369107424,1,1500,0,1482.72298587034,6,1500,0,1481.23369958281,6,1469.47686383627,7,1500,0,0,0,0,7,2,-1.1445922723463
"Ramos-Vinolas A.",1684.56371219005,120,1581.40606220448,47,1509.69305929097,7,1649.35410306042,66,1500,0,1655.30040135305,73,1635.36734170899,102,1565.26585142727,18,18,9,2.51085091382121,102,46,4.87169757378086
"Krajinovic F.",1460.16854062181,38,1457.82603522171,19,1493.21095536111,1,1489.06549241118,18,1500,0,1482.8428053849,19,1486.56270331118,30,1440.38806615169,8,8,1,-2.20214362118302,30,11,0.608885246055604
"Di Mauro A.",1508.6877460481,2,1500,0,1500,0,1507.65700732921,2,1500,0,1507.82686134557,2,1508.27719851681,2,1500,0,0,0,0,2,1,0.347509841923847
"Tavares L.",1491.89009595456,3,1500,0,1500,0,1491.64876344672,3,1500,0,1491.29898588447,3,1491.51824395899,3,1500,0,0,0,0,3,1,-0.324396161817424
"Munoz-De La Nava D.",1460.95688873365,27,1489.22089922074,10,1500,0,1455.24962976446,17,1500,0,1452.92606221328,17,1475.35193546696,23,1461.95522583755,4,4,0,-0.936784234561458,23,8,-0.624940216092607
"Kamke T.",1526.82348635693,158,1500.52033406759,94,1489.43361030475,21,1506.09330981083,43,1500,0,1514.29387945546,64,1538.55295213901,126,1439.77992439749,32,32,10,0.104555693150013,126,50,0.968383761127318
"Reister J.",1435.71300850063,46,1448.82335470616,5,1476.89453129701,9,1450.27601434498,32,1500,0,1443.05412604596,41,1431.16868636933,32,1475.30757206103,14,14,5,0.315857179439575,32,9,-2.88733683941429
"Zemlja G.",1578.2538786139,64,1518.56806409083,36,1503.5623105275,13,1519.56642476611,15,1500,0,1545.88551407358,28,1541.08059416425,45,1506.48249516455,19,19,8,1.73550528132503,45,20,1.39464986323088
"Kontinen H.",1490.39580862506,3,1486.15129363282,1,1502.03258774289,2,1500,0,1500,0,1501.60103088091,2,1490.67302747615,3,1500,0,0,0,0,3,1,-0.384167654997755
"Fischer M.",1374.61527846986,21,1447.22849377387,6,1480.37396902334,4,1412.95701596342,11,1500,0,1407.01432547895,15,1384.20689620367,17,1477.43621091748,4,4,1,-0.468146449235262,17,1,-4.54724241197015
"Kudla D.",1466.88259236882,87,1432.17685212341,53,1512.45900730911,25,1465.90898405497,9,1500,0,1502.68292707444,34,1465.89438359142,66,1463.6924506446,21,21,7,0.0457602012642575,66,22,-1.37045650651131
"Bubka S.",1494.324253372,17,1495.72946880521,13,1487.7177828518,3,1491.74977316931,1,1500,0,1480.70456055737,4,1485.30991786895,15,1508.16979237138,2,2,1,0.401842151589674,15,4,-0.62887201670963
"Skugor F.",1459.93310201949,15,1503.38568918102,3,1486.26924017447,1,1450.16295888653,11,1500,0,1444.3776268864,12,1460.24717031829,14,1489.72727409536,1,1,0,-0.263929900729953,14,4,-1.3387460184904
"Sadecky A.",1493.2388316618,3,1500,0,1500,0,1488.90255476922,3,1500,0,1489.59470691258,3,1492.88482010579,3,1500,0,0,0,0,3,1,-0.270446733527809
"Haider-Maurer A.",1545.05348584321,98,1488.94276760214,35,1447.07938547755,13,1529.36940667383,50,1500,0,1504.60523414574,63,1531.1989402909,76,1466.25514197346,22,22,7,0.0295175602518222,76,31,1.77262187347667
"Smyczek T.",1518.65154521741,98,1510.22963656835,77,1461.67641327297,11,1474.96749868309,10,1500,0,1453.89663268128,21,1499.70302083773,79,1485.20370305429,19,19,7,1.22268607309413,79,28,-0.476624264397655
"Paire B.",1570.65410543901,258,1552.93547638374,134,1468.34623713438,24,1617.6200016362,100,1500,0,1581.25053699365,124,1563.78545794633,211,1556.95808696666,47,47,23,1.4498972470571,211,98,1.37626697050351
"Ungur A.",1404.80714017282,33,1456.18933457143,5,1468.06655928338,3,1433.22674214532,25,1500,0,1413.07044448619,28,1429.56274028728,25,1448.5543089649,8,8,1,-1.198303341303,25,5,-2.60941105178424
"Bemelmans R.",1510.75021481096,41,1514.19515317563,24,1444.17681583916,13,1477.62960040987,4,1500,0,1450.77707731204,17,1498.98503845999,30,1468.80005366699,11,11,3,0.234173789471444,30,10,0.195834802966898
"Bhambri Y.",1485.44973522955,14,1471.11528238421,14,1500,0,1500,0,1500,0,1500,0,1485.48293183123,12,1495.3651061316,2,2,0,-0.123577198756491,12,4,-0.45843339206147
"Raonic M.",1965.15883060767,358,1893.74388485818,244,1690.50366561502,41,1762.04081961033,73,1500,0,1854.61345452559,114,1923.9788506976,277,1795.76261926994,81,81,58,2.91825691480859,277,186,15.6880963094981
"Bai Y.",1498.79764716314,7,1491.10678254364,7,1500,0,1500,0,1500,0,1500,0,1494.91174104203,7,1500,0,0,0,0,7,2,-0.0480941134745015
"Kravchuk K.",1434.63685023681,17,1446.61102728867,12,1463.80257316031,3,1500.70161711551,2,1500,0,1468.71606362322,5,1442.08206547105,15,1482.48188485973,2,2,0,-0.563933126004873,15,4,-2.05059286452287
"Donskoy E.",1455.4431765838,86,1469.52856169321,57,1477.11480230353,9,1387.14410974915,20,1500,0,1398.78080814685,29,1432.86046151397,68,1497.98778030096,18,18,7,2.23371978377353,68,19,-4.01599272042144
"Goffin D.",1832.50692578122,224,1770.40136434119,143,1572.92725952642,27,1696.00838730759,54,1500,0,1728.13895648472,81,1804.97100172746,181,1634.29411948752,43,43,25,2.81752364068945,181,100,10.4827533905593
"Sugita Y.",1472.20424707422,40,1436.51107994675,27,1491.95372521905,10,1493.39854121816,3,1500,0,1489.32984595118,13,1471.15799563312,37,1475.79809975095,3,3,0,-0.639982963725575,37,11,-0.47184715330582
"Wolmarans F.",1490.54606591063,3,1489.56876378171,3,1500,0,1500,0,1500,0,1500,0,1491.43079276042,3,1500,0,0,0,0,3,1,-0.378157363574613
"Zampieri C.",1495.09263377457,3,1500,0,1500,0,1496.66287794974,3,1500,0,1495.07949766338,3,1497.00802766743,3,1500,0,0,0,0,3,1,-0.196294649017005
"Gonzalez S.",1454.31435503824,9,1485.67908271117,1,1486.165679625,1,1476.5229278862,7,1500,0,1462.35576673492,8,1461.85146855422,8,1487.38338712421,1,1,0,-0.339483703910092,8,1,-1.48794209456038
"Kuznetsov An.",1677.05568305233,121,1615.00028950603,56,1492.76224371781,15,1540.30279618874,50,1500,0,1575.88119197222,65,1586.74534789169,90,1618.85059524559,31,31,17,6.57777341198919,90,37,0.504453910103947
"Ramos A.",1596.6281217405,147,1470.29353998389,48,1483.62484032503,5,1602.74595936975,94,1500,0,1601.73467791711,99,1608.43298075622,133,1436.06500710636,14,14,2,-2.54673628931839,133,65,6.41186115893825
"Teixeira M.",1473.51818597699,6,1480.80098764256,2,1500,0,1487.60710184762,4,1500,0,1491.92370012684,4,1475.43637144103,3,1498.73348273195,3,3,1,-0.0359166644164226,3,0,-1.02335589650394
"Schoorel T.",1486.22364386582,6,1471.29383813106,4,1500,0,1508.60350197079,2,1500,0,1508.03362788758,2,1473.80196436806,4,1506.13104333239,2,2,1,0.430896534254231,4,0,-0.98195077962136
"Marti J.",1451.49487607111,13,1493.36944092554,2,1497.1089078085,2,1444.54750148309,9,1500,0,1445.67341765102,11,1458.2773342092,12,1487.5,1,1,0,-0.480756012884237,12,2,-1.45944894427116
"Wang J.",1510.72650940369,21,1491.41619904223,7,1496.43061829138,10,1499.30571661101,4,1500,0,1508.98273807777,14,1480.14926118613,11,1514.23495595061,10,10,4,1.49642121367509,11,4,-1.06736083752738
"Yani M.",1447.14472836862,17,1437.41890237705,9,1521.19290776842,5,1462.72072764525,3,1500,0,1485.5110337873,8,1472.72989544665,13,1452.60683284002,4,4,0,-1.49672812286403,13,4,-0.61748274239121
"Dasnieres de Veigy J.",1473.79146859818,6,1484.11665419035,2,1500,0,1485.39214348353,4,1500,0,1483.95842942316,4,1488.03567128003,4,1487.21656381649,2,2,0,-0.54357989182896,4,1,-0.504761364243987
"Olaso G.",1491.21022268839,6,1485.80656568479,1,1500,0,1498.51959005724,5,1500,0,1498.39318648393,5,1489.59053318651,6,1500,0,0,0,0,6,2,-0.351591092464547
"Stebe C.M.",1524.01640790358,34,1462.12482437611,11,1486.29117100634,7,1550.51419507599,16,1500,0,1546.7851407241,23,1523.21404909867,26,1482.57198807846,8,8,2,-0.51596736692539,26,10,1.47662368306839
"Cervenak P.",1536.03974683286,8,1500,0,1500,0,1529.33077879381,8,1500,0,1531.50337485841,8,1534.44763757058,8,1500,0,0,0,0,8,5,1.4415898733142
"Del Bonis F.",1529.03100240639,13,1486.06311764957,1,1500,0,1540.73454070419,12,1500,0,1537.23641438435,12,1530.05413125606,13,1500,0,0,0,0,13,6,1.16124009625564
"Ito T.",1518.34984485158,76,1463.94276498995,49,1497.20774813583,18,1481.86556566655,9,1500,0,1497.61085788856,27,1518.52414463071,62,1434.70241906664,14,14,3,-0.908408849516971,62,24,1.64240264357991
"Knittel B.",1489.75147703618,5,1500,0,1486.18183332395,1,1489.45524086738,4,1500,0,1484.91084756622,5,1495.25997696435,4,1487.82752609701,1,1,0,-0.216735870493762,4,1,-0.193205048058921
"Kosakowski D.",1492.26477160794,3,1491.60978584857,3,1500,0,1500,0,1500,0,1500,0,1492.9290246172,3,1500,0,0,0,0,3,1,-0.309409135682391
"Pospisil V.",1597.7882088408,173,1620.49145295754,128,1483.68378726218,27,1412.798905813,18,1500,0,1450.58283598954,45,1592.72216037901,145,1489.38757605277,28,28,11,-2.34051405391407,145,65,6.25204240754603
"Duclos P.L.",1496.45485989249,4,1491.60400111502,3,1491.59441740376,1,1500,0,1500,0,1498.38513823234,1,1492.74171235062,4,1500,0,0,0,0,4,1,-0.141805604300244
"Jaziri M.",1577.02589896211,105,1530.39957835285,69,1461.81278973243,18,1515.0715206565,18,1500,0,1496.8671636832,36,1578.27123304018,86,1457.18062752454,19,19,6,0.0013801362771988,86,35,3.07965582220733
"Dutra Da Silva R.",1503.10350941787,2,1501.76400305262,2,1500,0,1500,0,1500,0,1500,0,1500,0,1499.30744768692,2,2,1,0.124140376714927,0,0,0
"Sock J.",1839.86602835621,191,1783.59357401663,135,1562.64731710363,18,1650.56602169004,38,1500,0,1686.68214094925,56,1814.79529813503,153,1603.13621246909,38,38,22,2.41965008220607,153,90,11.1749910520425
"Giannessi A.",1483.28174897027,11,1508.30898341414,2,1500,0,1476.28188697133,9,1500,0,1472.37246742027,9,1474.99659011714,9,1509.27825509931,2,2,1,0.450662364167956,9,3,-1.11939240535727
"Rodrigues M.",1511.63821361722,2,1510.8424258553,2,1500,0,1500,0,1500,0,1500,0,1509.96361198482,2,1500,0,0,0,0,2,1,0.465528544688947
"Renavand N.",1509.00552246368,2,1505.28298455563,2,1500,0,1500,0,1500,0,1500,0,1507.3926162329,2,1500,0,0,0,0,2,1,0.360220898547043
"Zhang Z.",1491.58344161804,15,1473.36161265752,13,1501.09290565611,2,1500,0,1500,0,1504.12393042908,2,1499.68111826136,13,1487.38533092508,2,2,0,-0.506266828119851,13,4,0.169604492841547
"Rieschick S.",1475.72288659014,4,1499.63991702395,2,1500,0,1472.82534212367,2,1500,0,1472.94033096304,2,1474.91226322812,4,1500,0,0,0,0,4,1,-0.971084536394345
"Lajovic D.",1596.86742591186,122,1517.16410311601,48,1457.1526582966,7,1580.71535150186,67,1500,0,1562.09942017523,74,1594.28430292632,103,1497.78188824404,19,19,8,1.50398115170111,103,43,2.37071588477338
"Bedene A.",1555.90064433382,117,1554.01006751171,57,1488.5294502343,14,1489.25579560599,46,1500,0,1499.7480434223,60,1540.6071476622,99,1455.33302035215,18,18,4,-1.62226486240638,99,45,3.85829063575897
"Thiem D.",1822.58403765797,199,1699.37770857272,100,1553.67270175593,17,1836.2646141199,82,1500,0,1837.42587978044,99,1791.83728861139,167,1634.68461200133,32,32,20,2.54356744975838,167,100,10.3597940565605
"Duckworth J.",1504.90498576631,55,1503.39464017956,40,1480.56544604052,7,1479.38346402965,8,1500,0,1465.97981116987,15,1519.05890845419,36,1447.17593425094,19,19,5,-2.03790280398023,36,14,2.23410223463283
"Dutra Silva R.",1425.08436582841,32,1511.36936798742,6,1463.4045135374,3,1417.83051545824,23,1500,0,1401.14593157265,26,1422.10498857228,22,1474.14131020895,10,10,2,0.177125947118794,22,5,-3.17375131398235
"Kutrovsky D.",1514.24682368438,3,1513.77632859852,3,1500,0,1500,0,1500,0,1500,0,1513.96838397941,3,1500,0,0,0,0,3,2,0.569872947375224
"Bagnis F.",1478.25757302109,33,1486.93533734204,2,1477.61793876833,2,1493.5896383728,29,1500,0,1475.41878308619,31,1482.87934753842,25,1473.43302993825,8,8,2,-0.335439797663737,25,9,-0.534257281492494
"Olivetti A.",1486.38941301546,14,1516.71852419895,11,1474.93619101084,2,1488.45977863279,1,1500,0,1464.11300759047,3,1516.84215557118,11,1461.45254490133,3,3,0,-1.4720710320018,11,5,0.927647552620347
"Bautista R.",1851.65650707378,220,1804.35060887991,145,1602.19962486876,19,1666.20627991839,56,1500,0,1695.17422691707,75,1807.78804802413,181,1675.66677724198,39,39,25,4.24814743337551,181,107,9.81811284957591
"Gutierrez-Ferrol S.",1499.26144202182,4,1500,0,1500,0,1502.93275650894,4,1500,0,1501.9641730585,4,1499.75214649142,4,1500,0,0,0,0,4,2,-0.029542319127174
"Delbonis F.",1592.12726166534,156,1476.86332475109,53,1446.52615304452,5,1654.14671944489,98,1500,0,1636.47242493251,103,1596.89234565085,138,1454.06102148827,18,18,5,-3.13297904574461,138,69,6.81806951235829
"Farah R.",1499.96469192793,9,1464.62221644138,3,1500,0,1528.3343901801,6,1500,0,1527.07250057173,6,1507.53410481038,8,1483.75255012613,1,1,0,-0.373150543358239,8,3,0.371738220475319
"Zopp J.",1459.30704764159,34,1477.88555991302,17,1462.73820778746,3,1474.26099111059,14,1500,0,1456.95403741347,17,1463.02314492778,23,1458.95090792749,11,11,2,-0.726531389955378,23,8,-0.901186704381091
"Balazs A.",1523.2691859967,7,1500,0,1500,0,1518.51346117594,7,1500,0,1522.28187032317,7,1521.9359486649,7,1500,0,0,0,0,7,4,0.930767439868038
"Cervantes I.",1487.95598147,48,1486.94551099456,13,1484.4451363358,4,1478.26514274722,31,1500,0,1466.86616114278,35,1486.36892190015,42,1473.71025196738,6,6,1,-0.394372962423501,42,16,-0.0873877787764032
"Pavic M.",1472.94168724146,11,1488.47345865561,1,1487.78708693211,5,1482.86999086551,5,1500,0,1471.4538107032,10,1471.54515126743,11,1500,0,0,0,0,11,3,-1.08233251034172
"Janowicz J.",1622.54058346136,152,1613.90022632486,96,1558.05970568265,20,1506.9214954185,36,1500,0,1559.46711113079,56,1626.24324248598,115,1581.27068522529,37,37,21,3.14228035062011,115,53,1.75934298783428
"De Schepper K.",1405.97122787132,76,1426.73489024744,32,1482.94109503567,20,1404.34223054783,24,1500,0,1414.48451788127,44,1398.98520820487,57,1463.13573041598,19,19,6,0.809261969389401,57,15,-4.57041285453666
"Trungelliti M.",1500.89515188298,10,1497.90614606204,3,1500,0,1498.23530467241,7,1500,0,1499.39230098177,7,1477.90067850467,6,1512.30915287486,4,4,2,0.846056475351899,6,2,-0.810250400032821
"Johnson S.",1707.56219710051,181,1657.06033011268,126,1601.10013624806,31,1483.61693270008,24,1500,0,1612.79706077367,55,1680.04315350739,149,1543.71779198081,32,32,14,0.35676865601214,149,75,7.94571922800849
"Oswald P.",1481.85776786805,4,1490.72764473282,1,1500,0,1489.12161243098,3,1500,0,1489.24610200017,3,1481.03263083101,4,1500,0,0,0,0,4,1,-0.725689285278076
"Mcclune M.",1506.14467487955,2,1504.30251318307,2,1500,0,1500,0,1500,0,1500,0,1503.59095818679,2,1500,0,0,0,0,2,1,0.245786995181878
"Novikov D.",1479.46156249639,11,1479.16746789005,7,1473.99504426189,4,1500,0,1500,0,1481.3360112892,4,1468.17852577654,7,1503.82310750414,4,4,2,0.468729471933932,7,1,-1.29026697207844
"Klahn B.",1437.10989241717,22,1457.76736677329,17,1472.38882727393,3,1475.44952970932,2,1500,0,1448.53921188198,5,1446.59715630596,13,1458.72580473305,9,9,2,-0.450962100216439,13,2,-2.06464220309657
"Reix C.",1510.27902792805,2,1508.37274601949,2,1500,0,1500,0,1500,0,1500,0,1509.92208861729,2,1500,0,0,0,0,2,1,0.411161117121834
"Millot V.",1466.43033578038,21,1471.35873660868,17,1486.52425134741,1,1466.75359584915,3,1500,0,1453.91619464931,4,1466.94958490776,16,1476.99191817216,5,5,1,-0.263665776383949,16,4,-1.07912079240088
"Moriya H.",1479.38743508123,11,1474.8384068351,10,1493.66674353965,1,1500,0,1500,0,1494.69547114864,1,1496.48627439978,8,1474.67876350867,3,3,0,-0.819589834118266,8,2,-0.00491276263272344
"Rosenholm P.",1508.2133701821,3,1505.12783191448,3,1500,0,1500,0,1500,0,1500,0,1506.43814676613,3,1500,0,0,0,0,3,1,0.328534807283836
"Millman J.",1604.39562120065,61,1539.57057556672,49,1528.03982861723,9,1467.76491309845,3,1500,0,1527.27682453944,12,1575.71499315041,48,1507.74533839463,13,13,5,1.10862404469615,48,20,3.0672008033299
"Stebe C-M.",1511.51023095353,2,1510.20174312933,2,1500,0,1500,0,1500,0,1500,0,1510.90251932557,2,1500,0,0,0,0,2,1,0.460409238141239
"Safwat M.",1491.70355609729,3,1490.40309817501,3,1500,0,1500,0,1500,0,1500,0,1491.189851603,3,1500,0,0,0,0,3,1,-0.331857756108505
"Jones G.",1469.65624048887,7,1473.09948678624,6,1490.1464389343,1,1500,0,1500,0,1489.00002561086,1,1473.57796425759,6,1491.08084332936,1,1,0,-0.179833872874346,6,1,-1.03391650757079
"Weintraub A.",1470.25827877891,5,1477.11027852356,4,1487.05655978978,1,1500,0,1500,0,1486.94034016957,1,1464.75128278879,3,1504.49957325422,2,2,1,0.300805453275295,3,0,-1.49047430211881
"Brugues-Davi A.",1490.654163753,4,1501.55776308756,3,1500,0,1487.22231632001,1,1500,0,1487.27147921557,1,1495.82251964893,3,1492.05141904948,1,1,0,-0.25875874310859,3,1,-0.115074706771471
"Garin C.",1475.95895322851,5,1500,0,1500,0,1472.45642523443,5,1500,0,1473.06057867673,5,1472.794431768,5,1500,0,0,0,0,5,1,-0.961641870859411
"Viola M.",1490.12808255517,13,1502.24797027235,6,1488.50602268253,1,1478.60966024183,6,1500,0,1467.75233896026,7,1485.86051721188,13,1500,0,0,0,0,13,4,-0.394876697793327
"Alund M.",1532.77821113882,17,1500,0,1493.39962565473,1,1533.5439988819,16,1500,0,1530.86545719188,17,1541.04088035238,15,1483.99408610768,2,2,0,-0.457529958246515,15,7,1.76865840379927
"Pella G.",1533.03129171156,68,1493.94699298997,26,1462.47980343969,4,1538.52885815367,38,1500,0,1514.75342392907,42,1518.35582917146,54,1486.98411912586,14,14,4,-0.389591071152132,54,21,1.71084273961455
"Schwartzman D.",1628.49324616849,77,1573.82221727631,28,1452.52498144162,4,1552.28409474104,45,1500,0,1521.33639798473,49,1636.28937335215,64,1467.22611629032,13,13,3,-0.743662510978001,64,28,5.88339235771778
"Williams R.",1461.66811247152,25,1464.43645358897,17,1480.42535663662,2,1501.92804615759,6,1500,0,1483.30058878644,8,1481.61464281189,20,1462.48918927685,5,5,0,-1.37561765429766,20,7,-0.157657846841568
"Laaksonen H.",1449.8810059479,20,1461.87965955603,7,1500,0,1467.90443000166,13,1500,0,1467.85923337892,13,1443.85583132985,20,1500,0,0,0,0,20,5,-2.00475976208417
"Carreno-Busta P.",1559.05750405115,107,1471.74075632227,40,1473.22233273004,3,1567.70116450615,64,1500,0,1556.10869615147,67,1543.81442757952,93,1493.47319929355,14,14,4,0.344000835212601,93,37,2.01829932683335
"Elias G.",1530.3911777896,43,1481.09523698861,9,1474.9810746238,2,1557.26528522516,32,1500,0,1540.22767001952,34,1557.2904425126,38,1444.00678135629,5,5,0,-2.13100286196551,38,16,3.34664997354952
"Kyrgios N.",1853.42726166193,113,1773.75765963121,68,1592.36692921612,15,1652.21952709533,30,1500,0,1721.46540861647,45,1808.32722864987,74,1676.7509166146,39,39,25,8.09302953416296,74,46,6.04406093231435
"Pouille L.",1785.08600363836,90,1677.63168807821,53,1513.38139006161,9,1627.84478062108,28,1500,0,1648.83378043464,37,1722.37137234992,69,1569.03662794351,21,21,10,1.28649185484009,69,37,10.1169482906945
"Basic M.",1516.57796146139,11,1514.04647290389,6,1499.31476593233,2,1489.47715861337,3,1500,0,1492.10884112066,5,1502.00545476628,9,1509.32054419855,2,2,1,0.580152805759485,9,4,0.0829656526959835
"Evans D.",1597.64731803395,39,1557.60394505328,21,1483.93671163094,18,1500,0,1500,0,1512.83933788633,18,1543.57498718687,26,1536.1944910217,13,13,6,2.46474638968361,26,11,1.44114633167435
"Edmund K.",1624.96825974601,50,1589.38954127241,29,1449.8644581509,13,1515.27464029859,8,1500,0,1490.54137756736,21,1582.34756601311,37,1508.97068317089,13,13,5,1.15494666785606,37,15,3.84378372198422
"Struff J.L.",1547.99422172761,94,1569.23973316602,47,1437.21515257086,14,1444.5498263693,33,1500,0,1420.53256560686,47,1558.17977820287,78,1427.33198611141,16,16,3,-2.60419359322297,78,31,4.52396246232726
"Kuznetsov Al.",1431.0547116716,21,1458.51340621889,12,1450.90989911672,6,1484.69655564827,3,1500,0,1449.05539602087,9,1440.45180812774,18,1466.02352054424,3,3,0,-0.954886630942846,18,5,-1.80292490219303
"Langer N.",1498.45764224206,3,1488.87840289261,1,1500,0,1505.79886670728,2,1500,0,1506.24944798938,2,1498.13599819184,3,1500,0,0,0,0,3,1,-0.0616943103174875
"Estrella Burgos V.",1542.33346377225,81,1433.39109172515,29,1474.25613893884,13,1600.44420636058,39,1500,0,1584.92535287777,52,1557.7065877349,66,1454.26295727899,15,15,4,-2.24812858587192,66,32,3.94146713676204
"Gomez E.",1502.48340608119,3,1489.53437016863,1,1500,0,1504.38505223243,2,1500,0,1504.76788149171,2,1500.53721600008,3,1500,0,0,0,0,3,1,0.0993362432476451
"Harrison C.",1500.27109765402,3,1497.24812551024,3,1500,0,1500,0,1500,0,1500,0,1509.14722768208,2,1488.35267289133,1,1,0,-0.371999870043438,2,1,0.382843776204364
"Peliwo F.",1490.15122450408,6,1490.04962368566,4,1500,0,1505.25563835092,2,1500,0,1504.78625224947,2,1490.18017459731,6,1500,0,0,0,0,6,2,-0.393951019836644
"Gojowczyk P.",1533.69895637148,26,1538.29342799393,18,1496.92458747229,4,1457.05813023297,4,1500,0,1464.28410223445,8,1541.11989731244,18,1468.21952791758,8,8,2,-0.787591915705635,18,8,2.1355501705647
"Fucsovics M.",1475.6384020403,8,1495.2526715459,3,1487.02623821531,1,1484.7884855898,4,1500,0,1474.59410895435,5,1478.49558765232,7,1492.53040869662,1,1,0,-0.272659042748873,7,2,-0.70180487563905
"Khachanov K.",1614.53247105988,29,1570.20235607079,20,1500,0,1518.300121861,9,1500,0,1518.86256998705,9,1598.53497766252,27,1507.72663615324,2,2,1,0.360681483435415,27,15,4.22061735895985
"Mecir M.",1488.68179501602,4,1493.64429535492,3,1500,0,1486.57682195013,1,1500,0,1487.13176912004,1,1499.69283585492,3,1486.73351022212,1,1,0,-0.49726276777464,3,1,0.0445345684155619
"Pospisil J.",1461.12319148011,8,1496.03599606854,3,1479.76849549584,2,1467.66079502044,3,1500,0,1451.71579966234,5,1467.37406455697,7,1489.29020954909,1,1,0,-0.318785578751752,7,1,-1.23628676204404
"Herbert P.H.",1519.08975068341,34,1486.60982551472,22,1515.4540395079,9,1473.6595919304,3,1500,0,1506.67516793584,12,1484.67081096548,22,1496.81490556552,12,12,5,1.06084747470296,22,7,-0.297257447366517
"Vesely J.",1664.13666059041,128,1543.88451084526,59,1532.76774677171,16,1587.37994832805,53,1500,0,1619.95274333688,69,1624.58089339591,105,1522.73686618032,23,23,10,0.919537404446513,105,48,5.64592901916997
"Ramanathan R.",1491.79421203062,8,1485.01014336016,8,1500,0,1500,0,1500,0,1500,0,1490.68471431684,8,1500,0,0,0,0,8,3,-0.328231518775137
"Dzumhur D.",1595.60626144987,63,1547.49432446943,33,1501.71873761323,5,1559.3968956068,25,1500,0,1557.3492738514,30,1579.81172901177,46,1519.13320309094,17,17,7,1.29893538286874,46,22,2.52531507512606
"Rola B.",1491.95154490043,25,1478.49839500809,9,1464.8993432815,5,1512.14016605026,11,1500,0,1490.82741945353,16,1502.22135360868,18,1476.97086323546,7,7,2,-0.439833210766543,18,7,0.117895006783777
"Kokkinakis T.",1545.70509890731,36,1497.79180599122,28,1492.20633035102,3,1503.77079595384,5,1500,0,1511.71430870599,8,1508.90324838371,27,1525.17712028482,9,9,4,1.60460247396214,27,9,0.223601482330373
"Daniel T.",1461.86989158855,33,1458.69182168734,11,1486.69121095624,1,1480.68689043607,21,1500,0,1476.68109256793,22,1457.18566894147,27,1475.83002457566,6,6,1,-0.00199154788326583,27,8,-1.52321278857471
"Gonzalez A.",1421.75120527612,46,1466.34713135947,21,1474.82836306867,2,1422.74057450263,23,1500,0,1413.3425631792,25,1408.4617370981,37,1483.43444609501,9,9,3,0.335292351052805,37,9,-3.46524414000783
"Carballes Baena R.",1498.57150870601,25,1489.68450037395,1,1500,0,1496.32640520629,24,1500,0,1492.65893869452,24,1504.00297755407,24,1487.5,1,1,0,-0.508609302101981,24,10,0.45146965034244
"Nedovyesov A.",1421.49274923362,23,1458.15906554905,11,1468.09662253098,3,1457.21804316108,9,1500,0,1431.97734739927,12,1414.85740310087,15,1484.78056003483,8,8,2,0.283890925312198,15,2,-3.42418095596724
"Milojevic N.",1505.38553610819,2,1500,0,1500,0,1501.25338552474,2,1500,0,1503.11243966623,2,1505.11827709587,2,1500,0,0,0,0,2,1,0.215421444327564
"Delic M.",1461.40168551402,10,1486.66474400285,2,1500,0,1465.76663635592,8,1500,0,1465.63649599698,8,1460.21962146461,10,1500,0,0,0,0,10,2,-1.54393257943932
"Kubler J.",1501.55905068341,3,1494.87463890473,1,1500,0,1499.82695631195,2,1500,0,1501.1373962265,2,1504.58160790702,2,1489.54790276339,1,1,0,-0.174775138907034,2,1,0.237137166243611
"Michon A.",1506.61817740558,2,1500,0,1500,0,1503.59380540328,2,1500,0,1504.02026031099,2,1500,0,1503.31910409437,2,2,1,0.264727096223061,0,0,0
"Saville L.",1475.53057035474,8,1475.90070976994,2,1485.99818807397,6,1500,0,1500,0,1493.00499701622,6,1502.03275230416,2,1460.48707603519,6,6,1,-1.01860592112119,2,1,0.0398287353106264
"Puetz T.",1500.23601453422,3,1488.66115373322,1,1499.51337809897,2,1500,0,1500,0,1508.3409774869,2,1500,0,1488.26731747444,3,3,1,0.009440581368656,0,0,0
"Pavic A.",1466.47006023331,13,1474.50907495346,5,1489.05748358891,6,1482.75519231884,2,1500,0,1472.1638745602,8,1459.83665154382,10,1499.17680875861,3,3,1,0.268769378032191,10,2,-1.60996696869967
"Lindell C.",1450.07853044471,10,1486.2551300277,1,1500,0,1460.60710916475,9,1500,0,1458.5592307778,9,1454.17937498376,9,1497.05301227411,1,1,0,-0.0965530478963389,9,2,-1.90030573431542
"Albot R.",1450.57666670628,23,1444.57002171754,13,1502.83059958493,2,1478.37513247086,8,1500,0,1479.92297338001,10,1452.28590468327,17,1480.14095028732,6,6,1,-0.453933533323137,17,4,-1.52299979842574
"Ymer E.",1448.35012251777,24,1436.17514332475,8,1492.65009746187,1,1486.0218231684,15,1500,0,1480.76643602625,16,1472.06408189594,20,1450.86611304221,4,4,0,-1.6234469242788,20,6,-0.442548175010461
"Olivo R.",1561.42713221057,23,1487.83642194727,3,1500,0,1558.95668036799,20,1500,0,1557.61055207138,20,1556.46279603706,21,1497.85267296299,2,2,1,0.133190944949207,21,11,2.32389434347342
"Krajicek A.",1500.79386445472,35,1513.88189290957,28,1478.84516026422,4,1463.82190681167,3,1500,0,1445.81234551833,7,1483.41214270273,30,1497.65370802838,5,5,2,0.474203962553733,30,10,-0.442449384364795
"Marti Y.",1477.11013347829,7,1500,0,1500,0,1477.218994326,7,1500,0,1474.53624204406,7,1475.3227491898,7,1500,0,0,0,0,7,2,-0.915594660868217
"Davydenko P.",1495.82790437425,3,1489.66173912416,1,1500,0,1505.12463738761,2,1500,0,1505.16455748978,2,1495.21875797081,3,1500,0,0,0,0,3,1,-0.16688382502985
"Zverev A.",1811.85504011762,108,1721.91601942871,54,1589.19097064789,17,1631.34229374753,37,1500,0,1684.90226123741,54,1795.55446647512,96,1530.30442407631,12,12,6,-0.542439036183923,96,56,13.0166406408889
"Coric B.",1683.17218645062,103,1633.67683218325,61,1481.38534896404,7,1584.26101223459,35,1500,0,1571.27114062572,42,1680.71814460172,88,1501.99987092017,15,15,6,-0.422604799058919,88,44,7.74949225708384
"Kohlschreiber P..",1502.31761245508,2,1500.2823747151,2,1500,0,1500,0,1500,0,1500,0,1502.46105289096,2,1500,0,0,0,0,2,1,0.0927044982032156
"Wang C.",1508.46777013758,2,1505.94372789731,2,1500,0,1500,0,1500,0,1500,0,1507.93178595277,2,1500,0,0,0,0,2,1,0.338710805503117
"Basilashvili N.",1515.86746981124,27,1485.52844835543,15,1520.9704474366,3,1499.9687755831,9,1500,0,1516.00910730829,12,1514.91295412103,20,1486.50152642804,7,7,2,-0.0813030604409899,20,8,0.716001852890412
"Venus M.",1454.63776051913,8,1455.64489265249,7,1500,0,1486.94353362769,1,1500,0,1487.463222459,1,1450.67850854423,8,1500,0,0,0,0,8,1,-1.81448957923479
"Melzer G.",1467.47734830569,22,1453.92626707279,5,1500,0,1494.39747234386,17,1500,0,1489.91388350575,17,1474.46589851524,21,1485.16246661667,1,1,0,-0.385310065993397,21,6,-0.915596001779
"Jarry N.",1479.5387595189,5,1477.29920990433,2,1500,0,1498.80039175175,3,1500,0,1498.15126643517,3,1477.5959845728,5,1500,0,0,0,0,5,1,-0.818449619243839
"Donaldson J.",1542.07432110253,30,1528.12646068466,26,1476.11408099482,4,1500,0,1500,0,1478.22043472481,4,1509.61832474414,25,1507.374930922,5,5,2,0.887054479619268,25,9,0.795918364482091
"Vanni L.",1446.65834977405,19,1452.50292925309,7,1484.59788940827,1,1484.07351282475,11,1500,0,1473.48708092793,12,1459.57376324591,17,1478.07470242775,2,2,0,-0.870721478792284,17,5,-1.26294453024574
"Rublev A.",1488.7446352138,25,1494.68550560729,15,1500,0,1471.8620859696,10,1500,0,1473.61087588049,10,1481.08395485148,24,1494.1982082877,1,1,0,-0.127253616303896,24,8,-0.322960975144007
"Nishioka Y.",1514.72558904567,29,1509.82649803523,26,1475.72678673903,2,1496.90358301032,1,1500,0,1472.85292985462,3,1529.88021177446,22,1453.75260390571,7,7,1,-1.07680640828465,22,10,1.66582997011149
"Arguello F.",1397.51123735472,16,1500,0,1491.64446328853,1,1395.97952622457,15,1500,0,1393.39226645929,16,1403.58427890431,14,1488.07063425701,2,2,0,-0.228682587985515,14,1,-3.87086791782588
"Andreozzi G.",1499.62500188918,4,1490.87131482297,2,1500,0,1507.08698748552,2,1500,0,1506.98154981792,2,1507.40978754008,2,1487.88091183902,2,2,0,-0.302711518836674,2,1,0.287711594403919
"Chung H.",1524.55444495533,38,1521.70766742299,25,1486.82562338887,3,1492.1166006333,10,1500,0,1485.09607642137,13,1524.55521166013,33,1483.54208475371,5,5,1,-0.711440257331034,33,14,1.69361805554417
"De Greef A.",1501.9272130337,2,1500,0,1500,0,1498.65042863706,2,1500,0,1497.73177393336,2,1502.29201440781,2,1500,0,0,0,0,2,1,0.0770885213480593
"Mektic N.",1478.63700935968,7,1477.77141905975,2,1500,0,1495.60751559227,5,1500,0,1496.45321866536,5,1478.67468937365,7,1500,0,0,0,0,7,2,-0.854519625612889
"Donati M.",1514.97816093292,2,1500,0,1500,0,1513.61804085039,2,1500,0,1513.93397382586,2,1514.46804794613,2,1500,0,0,0,0,2,1,0.599126437317005
"Mina G.",1486.91651715125,5,1500,0,1500,0,1477.47686753139,5,1500,0,1479.72640516915,5,1485.45192403411,4,1498.26354109255,1,1,0,-0.0281488782450656,4,1,-0.495190435704931
"Arnaboldi A.",1491.24624659286,10,1500,0,1500,0,1471.97440861419,10,1500,0,1476.51882998676,10,1485.14382243729,7,1495.46297679189,3,3,1,0.00678225921056219,7,2,-0.356932395496048
"Fritz T.",1530.48797013154,39,1518.98301571018,29,1484.07750865344,7,1494.51889168781,3,1500,0,1485.6041529144,10,1534.74749446719,35,1466.34580747703,4,4,0,-0.809853132495481,35,16,2.02937193775704
"Broady L.",1487.93712754724,5,1500,0,1470.90140158213,5,1500,0,1500,0,1478.09042587992,5,1477.70862408161,2,1497.92384918181,3,3,1,0.334396181160493,2,0,-0.816911079270733
"Smith J.P.",1464.20597771656,17,1442.51300151125,10,1512.42795119062,7,1500,0,1500,0,1510.77346235359,7,1489.21809248137,14,1467.20798408283,3,3,0,-1.437974189839,14,5,0.0062132985013813
"Demoliner M.",1499.54702818708,2,1500,0,1500,0,1496.90649229336,2,1500,0,1496.12812351697,2,1499.64680957809,2,1500,0,0,0,0,2,1,-0.0181188725166964
"Sarkissian A.",1498.92190290385,5,1494.68022080762,3,1500,0,1498.42950698519,2,1500,0,1498.35207245835,2,1497.83506484337,5,1500,0,0,0,0,5,2,-0.043123883846179
"Menendez-Maceiras A.",1451.47886184012,8,1468.7260653532,3,1472.07183640525,2,1486.33057728987,3,1500,0,1462.5774513853,5,1462.25789530852,6,1473.08058740639,2,2,0,-0.700254932649563,6,1,-1.24059059374558
"Galan D.E.",1504.42247595698,2,1500,0,1500,0,1501.0661308479,2,1500,0,1504.02293586795,2,1504.3127254232,2,1500,0,0,0,0,2,1,0.176899038279063
"Gomez A.",1504.7890864589,2,1500,0,1500,0,1497.96389654095,2,1500,0,1502.10660066876,2,1503.97029503491,2,1500,0,0,0,0,2,1,0.191563458355814
"Trinker B.",1505.08825503487,3,1500,0,1500,0,1506.30949830185,3,1500,0,1505.6097199506,3,1505.14635878401,3,1500,0,0,0,0,3,1,0.203530201394743
"Munar J.",1492.04207214372,4,1500,0,1500,0,1486.48764143023,4,1500,0,1485.64218236412,4,1490.00216761932,4,1500,0,0,0,0,4,1,-0.318317114251115
"Novak D.",1477.16620521134,5,1491.00404769568,1,1500,0,1483.30542977846,4,1500,0,1482.38230513798,4,1479.18729629277,5,1500,0,0,0,0,5,1,-0.913351791546476
"Herbert P.H",1573.65879272156,16,1551.02971107181,14,1500,0,1512.61344885592,2,1500,0,1512.96428046386,2,1571.43622440504,15,1491.67265815348,1,1,0,-0.265771467710799,15,8,3.21212317657338
"Tiafoe F.",1438.42435625943,14,1450.05861388365,11,1500,0,1468.13774918134,3,1500,0,1468.16986944128,3,1447.76791223225,11,1475.92884385211,3,3,0,-0.555629938951838,11,2,-1.90739581067081
"Zhang Zh.",1502.87410241174,2,1500.83085064272,2,1500,0,1500,0,1500,0,1500,0,1502.06484546532,2,1500,0,0,0,0,2,1,0.114964096469656
"Zhang Ze",1475.98966444611,7,1469.987529069,7,1500,0,1500,0,1500,0,1500,0,1473.74383419706,7,1500,0,0,0,0,7,1,-0.960413422155615
"Karatsev A.",1462.53492992296,7,1457.23071781139,7,1500,0,1500,0,1500,0,1500,0,1459.39742667445,7,1500,0,0,0,0,7,1,-1.49860280308156
"Fabbiano T.",1467.47304797451,20,1500.71823036647,11,1500,0,1434.25080075698,9,1500,0,1438.5218918097,9,1479.95240574683,17,1472.94149629857,3,3,0,-0.779044852365004,17,5,-0.522033228654616
"Barton M.",1530.75246492895,6,1516.48622443774,2,1503.29106746134,2,1503.07897215403,2,1500,0,1508.01075575621,4,1523.20640733595,4,1505.69630325448,2,2,1,0.275685031927714,4,2,0.954413565230465
"Thompson J.",1460.11661935384,14,1469.98850175053,9,1466.81585788869,3,1501.55175564662,2,1500,0,1471.81475174149,5,1491.1636420944,7,1449.16252123232,7,7,1,-1.43556384828718,7,2,-0.159771377559122
"Rubin N.",1466.10654640354,9,1464.20864187264,8,1486.58123927977,1,1500,0,1500,0,1486.00156764331,1,1461.74224563586,6,1489.72276099923,3,3,1,0.0190571509771251,6,1,-1.37479529483549
"Halys Q.",1491.89770682865,11,1494.39243138287,6,1500,0,1487.59738181857,5,1500,0,1487.00043610218,5,1466.76180015428,6,1508.9988293791,5,5,2,0.958364104321252,6,1,-1.28245583117508
"Jasika O.",1498.047760344,3,1495.8321147582,3,1500,0,1500,0,1500,0,1500,0,1484.88041596813,1,1508.30720230345,2,2,1,0.497953852097058,1,0,-0.576043438337208
"Monteiro T.",1536.26257824571,12,1474.9653169071,2,1500,0,1557.98143005563,10,1500,0,1558.68303068823,10,1534.11757881264,12,1500,0,0,0,0,12,6,1.45050312982855
"Fratangelo B.",1505.61136504954,17,1487.41896960505,14,1491.35842876223,1,1510.60650902435,2,1500,0,1507.3102855081,3,1515.5122879141,11,1472.98521612982,6,6,1,-0.599513547856828,11,5,0.823968149838496
"Kovalik J.",1471.8019778223,11,1478.51294190806,7,1500,0,1482.77085825132,4,1500,0,1482.59652245807,4,1490.77778498,9,1474.83694043401,2,2,0,-0.857076749705574,9,3,-0.270844137402484
"Paul T.",1466.75945899602,6,1460.13187573636,4,1500,0,1501.54590572973,2,1500,0,1500.49141344777,2,1470.27749825711,5,1491.9081552426,1,1,0,-0.233860408737513,5,1,-1.0957612314217
"Carreno Busta P.",1749.6035220384,51,1677.83176137645,27,1484.06727698682,2,1609.46338471427,22,1500,0,1597.36438144216,24,1728.79737053412,45,1513.94989414618,6,6,3,0.215438015203593,45,30,9.76870286633251
"Bautista Agut R.",1700.90269918788,41,1619.97658130266,23,1518.40696915454,5,1581.36332148985,13,1500,0,1595.41155000406,18,1658.96333860422,32,1548.66400846377,9,9,6,2.09638192722649,32,19,5.93972604028879
"Cecchinato M.",1423.64480775741,20,1461.92290322279,4,1500,0,1427.6193995735,16,1500,0,1431.87740740167,16,1430.0792794494,17,1473.74090833493,3,3,0,-0.468516131861744,17,2,-2.58569155784181
"Pavlasek A.",1507.71082051961,6,1491.30093504232,1,1500,0,1516.01807567383,5,1500,0,1516.40082946507,5,1500.65121635119,4,1505.31139836935,2,2,1,0.218866478530266,4,2,0.0895663422542402
"Bourgue M.",1511.79218093398,2,1500,0,1500,0,1510.94847697516,2,1500,0,1511.45186748339,2,1500,0,1511.01477344476,2,2,1,0.471687237359021,0,0,0
"Kozlov S.",1490.58055674705,9,1465.81900800389,3,1503.21431804243,6,1500,0,1500,0,1500.70973822217,6,1487.40698047876,9,1500,0,0,0,0,9,3,-0.37677773011807
"Medvedev D.",1522.73635158561,10,1522.10166455355,5,1499.98875138098,2,1489.33777150494,3,1500,0,1488.56176372222,5,1521.45095053661,10,1500,0,0,0,0,10,5,0.909454063424361
"Escobedo E.",1491.21664872655,6,1490.01140045292,3,1490.78745560839,3,1500,0,1500,0,1493.75944450748,3,1489.11633664429,4,1497.39216780773,2,2,1,0.0554506099447349,4,1,-0.406784660882837
"Willis M.",1512.35718064176,2,1500,0,1507.80912126621,2,1500,0,1500,0,1506.80190809832,2,1500,0,1510.86139578815,2,2,1,0.494287225670369,0,0,0
"Hemery C.",1498.20124666766,3,1500,0,1500,0,1499.7673237745,3,1500,0,1498.17165461056,3,1497.41574947632,3,1500,0,0,0,0,3,1,-0.0719501332936389
"Soderlund C.",1504.98140347852,2,1500,0,1500,0,1503.9065340874,2,1500,0,1503.85030628294,2,1503.9345666421,2,1500,0,0,0,0,2,1,0.199256139140677
"Kicker N.",1497.81445097081,3,1500,0,1500,0,1492.69381418462,3,1500,0,1492.4304509984,3,1497.29053597468,3,1500,0,0,0,0,3,1,-0.0874219611676841
"Wessels L.",1503.98239843884,2,1500,0,1500,0,1502.76356436455,2,1500,0,1501.77451993176,2,1504.63060714537,2,1500,0,0,0,0,2,1,0.1592959375536
"Mertl J.",1505.57661782432,2,1500,0,1500,0,1502.26123127582,2,1500,0,1503.13713793448,2,1503.90041688671,2,1500,0,0,0,0,2,1,0.223064712972727
"Lamasine T.",1488.11627120468,4,1500,0,1490.78737908924,1,1492.57109144921,3,1500,0,1486.18175255003,4,1491.27725141728,3,1492.91845971546,1,1,0,-0.241576405834526,3,1,-0.233772745978162
"Munoz De La Nava D.",1442.28261002692,8,1500,0,1500,0,1437.29090158771,8,1500,0,1438.5251184673,8,1450.84429109935,7,1484.7681561253,1,1,0,-0.476722465269106,7,1,-1.83197313365396
"Cacic N.",1507.13798073314,2,1500,0,1500,0,1503.66468395084,2,1500,0,1503.76251430913,2,1504.72109801643,2,1500,0,0,0,0,2,1,0.285519229325694
"Diez S.",1473.65329835853,5,1494.01991609305,3,1500,0,1474.52713389164,2,1500,0,1474.64354576419,2,1473.46228339174,5,1500,0,0,0,0,5,1,-1.05386806565882
"Shapovalov D.",1504.1540036772,3,1502.05596939406,3,1500,0,1500,0,1500,0,1500,0,1502.4115557681,3,1500,0,0,0,0,3,1,0.166160147088089
"Opelka R.",1547.62703451002,10,1548.51847570534,9,1500,0,1489.59991985693,1,1500,0,1492.7011946544,1,1541.68701410238,10,1500,0,0,0,0,10,5,1.90508138040093
"Satral J.",1503.13706512811,3,1508.88181874227,2,1500,0,1494.79579184993,1,1500,0,1494.20219644116,1,1493.52098127918,1,1507.03824907401,2,2,1,0.368844069608011,1,0,-0.243361464483673
"Wu D.",1445.44126634145,17,1430.06474238388,17,1500,0,1500,0,1500,0,1500,0,1464.98299525643,14,1461.57385000118,3,3,0,-1.16351674134646,14,2,-1.01883260499536
"Whittington A.",1507.87907987509,2,1507.08641827185,2,1500,0,1500,0,1500,0,1500,0,1507.4792399667,2,1500,0,0,0,0,2,1,0.315163195003593
"Bublik A.",1512.52034663882,4,1508.73356608459,4,1500,0,1500,0,1500,0,1500,0,1511.17061870765,4,1500,0,0,0,0,4,2,0.500813865552868
"Ymer M.",1504.37828520001,3,1498.11503997538,3,1500,0,1500,0,1500,0,1500,0,1502.9038551498,3,1500,0,0,0,0,3,1,0.175131408000534
NA,1487.5,2,1500,0,1500,0,1500,0,1500,0,1487.5,2,1500,0,1500,0,0,0,0,0,0,0
"Kumar S.",1487.5,1,1487.5,1,1500,0,1500,0,1500,0,1500,0,1487.5,1,1500,0,0,0,0,1,0,-0.5
"Spottl M.",1476.30632494379,2,1487.5,1,1500,0,1487.94952970932,1,1500,0,1487.94952970932,1,1476.70801841533,2,1500,0,0,0,0,2,0,-0.947747002248216
"Kilderry P.",1465.50196613381,3,1476.43059672736,2,1487.53285919994,1,1500,0,1500,0,1486.43182867723,1,1477.88807087411,2,1487.03431883644,1,1,0,-0.512595933935963,2,0,-0.867325420711678
"Ishii Y.",1451.63772642605,4,1450.1681471853,4,1500,0,1500,0,1500,0,1500,0,1450.88946810902,4,1500,0,0,0,0,4,0,-1.93449094295803
"Al-Alawi S.K.",1476.2090159111,2,1476.70103448973,2,1500,0,1500,0,1500,0,1500,0,1475.36716985712,2,1500,0,0,0,0,2,0,-0.951639363555864
"Luxa P.",1426.96176355725,7,1446.38698415853,5,1478.98143414785,2,1500,0,1500,0,1476.76358585043,2,1434.59271209399,6,1488.33647355897,1,1,0,-0.297055997602601,6,0,-2.62447346010752
"Sanchez J.",1487.5,1,1487.5,1,1500,0,1500,0,1500,0,1500,0,1487.5,1,1500,0,0,0,0,1,0,-0.5
"Costa F.",1453.49660015495,4,1475.37197096268,2,1500,0,1475.46916770222,2,1500,0,1475.42214282843,2,1452.54150447145,4,1500,0,0,0,0,4,0,-1.86013599380217
"Karbacher B.",1476.8182945488,2,1487.5,1,1500,0,1490.01983832257,1,1500,0,1489.30744084328,1,1488.42148939367,1,1487.5,1,1,0,-0.5,1,0,-0.427268218048157
"Kulti N.",1443.87161364371,5,1477.25226343296,2,1487.5,1,1476.30322947157,2,1500,0,1464.17857388682,3,1453.5169095613,4,1487.5,1,1,0,-0.5,4,0,-1.74513545425152
"Raoux G.",1476.13666343609,2,1486.60210182637,1,1500,0,1490.19875398687,1,1500,0,1490.19875398687,1,1487.05047029068,1,1487.94952970932,1,1,0,-0.418617535611414,1,0,-0.535915926945102
"Humphries S.",1457.55377365069,4,1466.78068029028,3,1500,0,1488.88517875201,1,1500,0,1488.88517875201,1,1456.07062128465,4,1500,0,0,0,0,4,0,-1.69784905397225
"Jensen L.",1487.193203992,1,1487.193203992,1,1500,0,1500,0,1500,0,1500,0,1487.54666650777,1,1500,0,0,0,0,1,0,-0.512271840320018
"Knowles M.",1473.66691066384,2,1473.9774004463,2,1500,0,1500,0,1500,0,1500,0,1473.7730632567,2,1500,0,0,0,0,2,0,-1.05332357344649
"Stark J.",1474.34813581396,2,1487.17747193893,1,1487.40845347911,1,1500,0,1500,0,1487.35385913419,1,1474.18545502116,2,1500,0,0,0,0,2,0,-1.0260745674414
"Szymanski J.",1488.1922155324,1,1488.69340830561,1,1500,0,1500,0,1500,0,1500,0,1488.19673314412,1,1500,0,0,0,0,1,0,-0.472311378704136
"Gonzalez P.",1486.5699717041,1,1500,0,1500,0,1487.05047029068,1,1500,0,1487.05047029068,1,1486.58603521976,1,1500,0,0,0,0,1,0,-0.537201131836122
"Cortes J.",1489.34412804458,1,1500,0,1500,0,1490.03380633673,1,1500,0,1490.03380633673,1,1489.63728893529,1,1500,0,0,0,0,1,0,-0.426234878216702
"Harper-Griffith L.",1478.12124638831,2,1488.00431612765,1,1500,0,1487.5,1,1500,0,1487.5,1,1487.02758889245,1,1487.44071402391,1,1,0,-0.347834684038025,1,0,-0.527315460429663
"Marques N.",1488.96081715722,1,1500,0,1500,0,1487.5,1,1500,0,1487.5,1,1488.28924682315,1,1500,0,0,0,0,1,0,-0.44156731371111
"Garcia M.",1477.67027065819,2,1500,0,1489.05126175977,1,1487.5,1,1500,0,1476.87581942388,2,1478.33932254069,2,1500,0,0,0,0,2,0,-0.893189173672581
"Fahlke A.",1487.30579267943,1,1500,0,1500,0,1487.06662324804,1,1500,0,1487.06662324804,1,1487.55437296487,1,1500,0,0,0,0,1,0,-0.507768292822706
"Witt A.",1485.33285954229,1,1500,0,1487.5,1,1500,0,1500,0,1486.59834438393,1,1485.72465410557,1,1500,0,0,0,0,1,0,-0.586685618308533
"Landsberg J.",1488.19303627943,1,1500,0,1487.5,1,1500,0,1500,0,1488.41516063142,1,1488.3218158495,1,1500,0,0,0,0,1,0,-0.472278548822773
"Boruszewski J.",1486.23291811231,1,1500,0,1487.05047029068,1,1500,0,1500,0,1485.84333782763,1,1486.59435159361,1,1500,0,0,0,0,1,0,-0.550683275507499
"Gaudi I.",1489.16971005653,1,1500,0,1487.5,1,1500,0,1500,0,1487.90038275359,1,1500,0,1489.21036834272,1,1,0,-0.433211597738792,0,0,0
"Bhupathi M.",1458.65245405623,3,1472.90963439048,2,1487.05047029068,1,1500,0,1500,0,1485.81696665046,1,1473.35504445699,2,1487.03431883644,1,1,0,-0.58078597319884,2,0,-1.07311586455205
"MacLagan M.",1472.1334686466,2,1484.90089059927,1,1487.46879591686,1,1500,0,1500,0,1487.38290027092,1,1484.71451623109,1,1487.5,1,1,0,-0.506324627517498,1,0,-0.608336626618462
"Timfjord N.",1485.42546234492,1,1500,0,1500,0,1486.32849315979,1,1500,0,1485.93633815433,1,1485.92318548771,1,1500,0,0,0,0,1,0,-0.582981506203337
"Fleischfresser T.",1485.57146487695,1,1500,0,1500,0,1486.38748850159,1,1500,0,1485.74049277651,1,1486.24162254538,1,1500,0,0,0,0,1,0,-0.577141404922123
"Arnold L.",1485.72737509472,1,1500,0,1500,0,1486.73501941213,1,1500,0,1485.49446860097,1,1486.71676127911,1,1500,0,0,0,0,1,0,-0.570904996211348
"Thomas J.",1473.66807192391,2,1485.14454530429,1,1488.36798559581,1,1500,0,1500,0,1488.3874797951,1,1473.72846517074,2,1500,0,0,0,0,2,0,-1.05327712304345
"Tiilikainen K.",1478.58117955264,2,1500,0,1500,0,1475.09420458815,2,1500,0,1476.06661777558,2,1478.67523228695,2,1500,0,0,0,0,2,0,-0.856752817894564
"Filippini M.",1476.81150684089,2,1500,0,1500,0,1477.73206079629,2,1500,0,1476.82430117533,2,1477.64557934487,2,1500,0,0,0,0,2,0,-0.92753972636456
"Miketa D.",1489.64686241562,1,1500,0,1500,0,1488.8067291179,1,1500,0,1488.5882366818,1,1488.77722167567,1,1500,0,0,0,0,1,0,-0.414125503375188
"Peschek D.",1488.36492282123,1,1500,0,1500,0,1487.21912092491,1,1500,0,1488.71469240311,1,1488.28614387785,1,1500,0,0,0,0,1,0,-0.465403087150754
"Vajda I.",1478.11965063204,2,1500,0,1500,0,1478.15490292748,2,1500,0,1477.50239360125,2,1479.24736031353,2,1500,0,0,0,0,2,0,-0.875213974718287
"Moretti H.",1488.63832896601,1,1500,0,1500,0,1488.53488575578,1,1500,0,1488.53488575578,1,1488.09314859492,1,1500,0,0,0,0,1,0,-0.454466841359543
"Trimmel C.",1479.56343068997,2,1500,0,1500,0,1479.21522613043,2,1500,0,1479.14149028635,2,1479.5757000899,2,1500,0,0,0,0,2,0,-0.817462772401276
"Vasek R.",1487.49579726783,1,1500,0,1500,0,1487.33335948028,1,1500,0,1487.36071422101,1,1487.12994468016,1,1500,0,0,0,0,1,0,-0.500168109286677
"Fasching A.",1487.44725729058,1,1500,0,1500,0,1487.66373726375,1,1500,0,1487.11401799652,1,1488.22132713935,1,1500,0,0,0,0,1,0,-0.502109708376966
"Cabello F.",1485.74913767491,1,1500,0,1500,0,1486.99643150406,1,1500,0,1486.70056587855,1,1486.10353637997,1,1500,0,0,0,0,1,0,-0.570034493003543
"Cobolli S.",1489.34046019941,1,1500,0,1500,0,1490.29772565237,1,1500,0,1489.66751285206,1,1488.90921511698,1,1500,0,0,0,0,1,0,-0.426381592023582
"Malcor O.",1472.02005769477,2,1500,0,1500,0,1472.61798124181,2,1500,0,1472.24108940302,2,1473.26312781615,2,1500,0,0,0,0,2,0,-1.11919769220908
"Tramacchi P.",1487.31839103294,1,1486.76061256292,1,1500,0,1500,0,1500,0,1500,0,1487.81971118125,1,1500,0,0,0,0,1,0,-0.507264358682294
"Mor L.",1487.30934559922,1,1487.64918591405,1,1500,0,1500,0,1500,0,1500,0,1487.23488231109,1,1500,0,0,0,0,1,0,-0.507626176031037
"Caldwell D.",1486.98631595699,1,1487.5,1,1500,0,1500,0,1500,0,1500,0,1487.00184355276,1,1500,0,0,0,0,1,0,-0.520547361720271
"Harsanyi P.",1475.40931700945,2,1473.58826250322,2,1500,0,1500,0,1500,0,1500,0,1475.01029814503,2,1500,0,0,0,0,2,0,-0.983627319621813
"Kauffmann C.",1480.05225558497,2,1485.73093559435,1,1500,0,1486.1172089143,1,1500,0,1490.28553031569,1,1500,0,1480.15192042461,2,2,0,-0.797909776601329,0,0,0
"Herm-Zahlava J.",1472.4177557998,2,1500,0,1500,0,1473.63697505522,2,1500,0,1472.75289700282,2,1472.7810633264,2,1500,0,0,0,0,2,0,-1.10328976800792
"Tong M.",1488.53339301921,1,1486.4682441455,1,1500,0,1500,0,1500,0,1500,0,1487.58091064217,1,1500,0,0,0,0,1,0,-0.45866427923143
"Onoda M.",1449.77267981251,4,1451.35010006477,4,1500,0,1500,0,1500,0,1500,0,1450.88578658536,4,1500,0,0,0,0,4,0,-2.00909280749948
"Miyao J.",1475.61800055353,2,1478.01701483408,2,1500,0,1500,0,1500,0,1500,0,1476.49638020517,2,1500,0,0,0,0,2,0,-0.975279977859004
"Mlynarik Z.",1490.55429202359,1,1488.8597992495,1,1500,0,1500,0,1500,0,1500,0,1490.3673674463,1,1500,0,0,0,0,1,0,-0.377828319056317
"Zhang Y.",1487.18987476134,1,1486.74045106283,1,1500,0,1500,0,1500,0,1500,0,1487.02527902609,1,1500,0,0,0,0,1,0,-0.512405009546282
"Kornienko I.",1495.33209366339,1,1493.49923334255,1,1500,0,1500,0,1500,0,1500,0,1494.09320934807,1,1500,0,0,0,0,1,0,-0.18671625346433
"Freelove O.",1488.91401316778,1,1487.07709401067,1,1500,0,1500,0,1500,0,1500,0,1488.98226185829,1,1500,0,0,0,0,1,0,-0.443439473288889
"Milligan L.",1485.22883583615,2,1487.03429066708,1,1487.05047029068,1,1500,0,1500,0,1495.5151200899,1,1487.32810339297,1,1491.40220527667,1,1,0,-0.156976883988972,1,0,-0.433869682565153
"Sarstrand M.",1482.90330407827,2,1488.23340498301,1,1500,0,1494.44961762298,1,1500,0,1494.31059678063,1,1482.03163854535,2,1500,0,0,0,0,2,0,-0.683867836869047
"Smith L.",1490.50802328266,1,1490.00012346342,1,1500,0,1500,0,1500,0,1500,0,1490.22341444298,1,1500,0,0,0,0,1,0,-0.379679068693565
"Syed F.",1484.52582833012,1,1486.13975426745,1,1500,0,1500,0,1500,0,1500,0,1484.58786256987,1,1500,0,0,0,0,1,0,-0.618966866795167
"Breen M.",1485.99593942127,1,1486.13270745657,1,1500,0,1500,0,1500,0,1500,0,1500,0,1486.6181929939,1,1,0,-0.560162423149151,0,0,0
"Perry T.",1488.07340078013,1,1487.61516662242,1,1500,0,1500,0,1500,0,1500,0,1500,0,1488.09148997889,1,1,0,-0.477063968794946,0,0,0
"Svarc L.",1477.77720243484,2,1488.44902321627,1,1500,0,1489.13183964878,1,1500,0,1488.21486090273,1,1489.83216596999,1,1488.03217388544,1,1,0,-0.490516800272148,1,0,-0.398395102334106
"Moyano D.",1474.35709247381,2,1500,0,1500,0,1474.80656031102,2,1500,0,1474.70371247814,2,1474.81084325165,2,1500,0,0,0,0,2,0,-1.02571630104746
"Koll H.",1484.79970714286,1,1485.63726487658,1,1500,0,1500,0,1500,0,1500,0,1484.90686108861,1,1500,0,0,0,0,1,0,-0.608011714285717
"Arquez P.",1487.17624173084,1,1500,0,1500,0,1488.06838758785,1,1500,0,1488.03885206101,1,1487.95636556037,1,1500,0,0,0,0,1,0,-0.512950330766347
"Eagle J.",1487.50476940702,1,1488.05562443818,1,1500,0,1500,0,1500,0,1500,0,1487.58685295546,1,1500,0,0,0,0,1,0,-0.499809223719329
"Bahrouzyan O.",1446.23449915228,7,1441.45604074628,7,1500,0,1500,0,1500,0,1500,0,1441.3543382629,7,1500,0,0,0,0,7,0,-2.1506200339087
"Belal C.",1487.06354646041,1,1500,0,1500,0,1488.93895204411,1,1500,0,1488.97787239165,1,1487.15662676063,1,1500,0,0,0,0,1,0,-0.517458141583558
"Couto E.",1486.52757437398,1,1500,0,1500,0,1486.51568839184,1,1500,0,1486.59815009356,1,1485.5649053173,1,1500,0,0,0,0,1,0,-0.538897025040716
"Sousa T.",1486.85096634608,1,1500,0,1500,0,1487.96247731529,1,1500,0,1487.07600149779,1,1487.1691635802,1,1500,0,0,0,0,1,0,-0.525961346156851
"Navarra M.",1488.87339534169,1,1500,0,1500,0,1490.10870128481,1,1500,0,1489.83106479502,1,1489.5163431379,1,1500,0,0,0,0,1,0,-0.445064186332467
"Derepasko A.",1493.68072535846,1,1500,0,1489.01494813735,1,1500,0,1500,0,1490.2391548751,1,1500,0,1490.89034266623,1,1,0,-0.252770985661426,0,0,0
"Vlasov D.",1490.03494060483,1,1500,0,1500,0,1491.39293963992,1,1500,0,1490.4136951306,1,1490.44267867946,1,1500,0,0,0,0,1,0,-0.398602375806677
"Tkalec M.",1487.26852648962,1,1500,0,1500,0,1488.57725421373,1,1500,0,1488.53102723833,1,1487.26114796931,1,1500,0,0,0,0,1,0,-0.509258940415194
"Bozic I.",1486.60661875747,1,1500,0,1500,0,1486.67622950858,1,1500,0,1486.67557093898,1,1487.07193776479,1,1500,0,0,0,0,1,0,-0.535735249701321
"Pfeiffer K.",1491.08055617298,1,1500,0,1500,0,1490.38448086801,1,1500,0,1490.80700871365,1,1490.80315141305,1,1500,0,0,0,0,1,0,-0.356777753080824
"Peppas S.",1490.54984801325,1,1500,0,1500,0,1491.86003385844,1,1500,0,1491.103928286,1,1490.3418768434,1,1500,0,0,0,0,1,0,-0.378006079469897
"Oncins J.",1486.16799863408,1,1487.29141496399,1,1500,0,1500,0,1500,0,1500,0,1486.70045129341,1,1500,0,0,0,0,1,0,-0.553280054636882
"Tomashevich D.",1487.89467279714,1,1490.54136187308,1,1500,0,1500,0,1500,0,1500,0,1487.70062674714,1,1500,0,0,0,0,1,0,-0.484213088114249
"Jiang S.",1486.84330128085,1,1489.02949817689,1,1500,0,1500,0,1500,0,1500,0,1487.51600906354,1,1500,0,0,0,0,1,0,-0.52626794876615
"Wang Y.",1459.59019722257,4,1468.73105973702,3,1500,0,1488.14872560047,1,1500,0,1488.18637675811,1,1458.7227971445,4,1500,0,0,0,0,4,0,-1.61639211109734
"Koenig R.",1484.37903248682,1,1487.6789418663,1,1500,0,1500,0,1500,0,1500,0,1484.58562404757,1,1500,0,0,0,0,1,0,-0.624838700527298
"Shimada T.",1472.83793966738,2,1488.01155102301,1,1487.05047029068,1,1500,0,1500,0,1485.6156867727,1,1473.43213236881,2,1500,0,0,0,0,2,0,-1.08648241330489
"Hui J.",1494.76281647637,1,1494.58348798335,1,1500,0,1500,0,1500,0,1500,0,1492.95774228097,1,1500,0,0,0,0,1,0,-0.209487340945368
"Garcia-Sintes J.",1488.54461789365,1,1500,0,1500,0,1489.83677377415,1,1500,0,1489.33772045793,1,1488.57729181683,1,1500,0,0,0,0,1,0,-0.458215284253887
"Zitko R.",1475.53500916895,2,1486.72442235371,1,1500,0,1487.22256596704,1,1500,0,1487.29478217895,1,1475.05942501526,2,1500,0,0,0,0,2,0,-0.978599633242078
"Dupre T.",1486.59020109672,1,1487.09422415995,1,1500,0,1500,0,1500,0,1500,0,1486.54902617052,1,1500,0,0,0,0,1,0,-0.53639195613138
"Al Khulaifi N.G.",1486.90370724553,1,1486.84237822244,1,1500,0,1500,0,1500,0,1500,0,1486.83122843323,1,1500,0,0,0,0,1,0,-0.52385171017863
"Willman D.",1491.06638538269,1,1489.84446145466,1,1500,0,1500,0,1500,0,1500,0,1491.09115705018,1,1500,0,0,0,0,1,0,-0.357344584692361
"Hormazabal G.",1463.39286704055,3,1500,0,1500,0,1467.2310736341,3,1500,0,1466.27345794404,3,1464.85198774066,3,1500,0,0,0,0,3,0,-1.46428531837798
"Olguin L.",1493.2320722632,1,1500,0,1500,0,1492.92691764391,1,1500,0,1492.39811956101,1,1492.39188018301,1,1500,0,0,0,0,1,0,-0.27071710947215
"Mazarakis V.",1465.81102874309,5,1486.32102402889,2,1500,0,1476.57583462829,3,1500,0,1475.5398207016,3,1464.79907031268,5,1500,0,0,0,0,5,0,-1.3675588502765
"Matias N.",1489.45657065019,1,1500,0,1500,0,1490.323602143,1,1500,0,1490.15805256396,1,1489.59934202453,1,1500,0,0,0,0,1,0,-0.421737173992533
"Marin L.",1490.63865739596,1,1500,0,1500,0,1490.58867241758,1,1500,0,1490.13679004609,1,1490.93322458926,1,1500,0,0,0,0,1,0,-0.374453704161527
"Albert M.",1489.66867270552,1,1500,0,1500,0,1490.09725652494,1,1500,0,1489.94003485881,1,1489.43124302376,1,1500,0,0,0,0,1,0,-0.413253091779333
"Ager J.",1473.56228891435,2,1500,0,1500,0,1475.16858467856,2,1500,0,1474.69343290593,2,1474.42187349009,2,1500,0,0,0,0,2,0,-1.057508443426
"Dreekmann H.",1489.94284081222,2,1500,0,1477.24284340865,2,1500,0,1500,0,1484.36022815647,2,1488.69787883716,2,1500,0,0,0,0,2,0,-0.402286367511067
"Coetzee J.",1488.01280643195,1,1500,0,1487.1085889547,1,1500,0,1500,0,1485.08361930805,1,1487.99646574837,1,1500,0,0,0,0,1,0,-0.479487742721923
"Ivanov-Smolensky K.",1472.24654829356,2,1487.74432044863,1,1487.09484338784,1,1500,0,1500,0,1486.7794115127,1,1473.62223779591,2,1500,0,0,0,0,2,0,-1.11013806825758
"Golovanov D.",1479.62969584119,2,1491.51767711081,1,1485.4129468086,1,1500,0,1500,0,1483.80702424382,1,1492.82632976877,1,1485.64145902528,1,1,0,-0.60513491876394,1,0,-0.209677247588544
"Mackin A.",1425.80160602842,9,1487.27071600461,1,1431.28176408051,6,1482.50202451846,2,1500,0,1428.1554034255,8,1460.74659595646,4,1449.53986627207,5,5,0,-1.4910198527716,4,0,-1.47691590609158
"Todero N.",1488.71212688527,1,1500,0,1500,0,1488.1243563474,1,1500,0,1487.38921250984,1,1488.63837893649,1,1500,0,0,0,0,1,0,-0.451514924589005
"Ellwood B.",1485.00362079966,1,1500,0,1487.08393385482,1,1500,0,1500,0,1486.20570042075,1,1484.81034894018,1,1500,0,0,0,0,1,0,-0.599855168013499
"Kennedy A.",1469.21933874407,3,1480.86078638318,2,1486.20702040592,1,1500,0,1500,0,1486.24152613668,1,1468.13970489613,3,1500,0,0,0,0,3,0,-1.23122645023711
"Nijaki R.",1488.90805335672,1,1500,0,1500,0,1488.8092905224,1,1500,0,1488.80953228939,1,1487.40226492387,1,1500,0,0,0,0,1,0,-0.443677865731299
"Dabrowski B.",1490.86198613991,2,1500,0,1500,0,1487.9907582828,2,1500,0,1489.7199409527,2,1487.97541937748,2,1500,0,0,0,0,2,0,-0.365520554403758
"Agaev E.",1489.56155259498,1,1488.17194499842,1,1500,0,1500,0,1500,0,1500,0,1488.67684275188,1,1500,0,0,0,0,1,0,-0.417537896200788
"Spracklin T.",1485.26674947516,1,1485.88291963335,1,1500,0,1500,0,1500,0,1500,0,1485.50899751439,1,1500,0,0,0,0,1,0,-0.589330020993609
"Hanley P.",1487.77812854551,1,1485.81727880318,1,1500,0,1500,0,1500,0,1500,0,1488.12263496116,1,1500,0,0,0,0,1,0,-0.488874858179569
"Lukaev R.",1485.50870434236,1,1484.84218403415,1,1500,0,1500,0,1500,0,1500,0,1500,0,1486.33064198689,1,1,0,-0.579651826305536,0,0,0
"Kunitcin I.",1486.18073860236,1,1486.61529400502,1,1500,0,1500,0,1500,0,1500,0,1500,0,1486.19852786865,1,1,0,-0.552770455905584,0,0,0
"Craca M.",1486.12301214369,1,1500,0,1500,0,1485.80432561013,1,1500,0,1485.71717175283,1,1486.56732561523,1,1500,0,0,0,0,1,0,-0.555079514252522
"Bohaboy D.",1486.03597496059,1,1484.92284420204,1,1500,0,1500,0,1500,0,1500,0,1486.21479973114,1,1500,0,0,0,0,1,0,-0.558561001576536
"Shvec A.",1493.92249332224,1,1489.52014150152,1,1500,0,1500,0,1500,0,1500,0,1493.97580426205,1,1500,0,0,0,0,1,0,-0.243100267110591
"Khalfan S.",1464.70909090308,3,1460.19922164325,3,1500,0,1500,0,1500,0,1500,0,1464.63363417641,3,1500,0,0,0,0,3,0,-1.41163636387679
"Rea S.",1476.47731760903,2,1475.77995279798,2,1500,0,1500,0,1500,0,1500,0,1474.94843703714,2,1500,0,0,0,0,2,0,-0.940907295638676
"Durek R.",1488.68195404879,1,1488.05942416087,1,1500,0,1500,0,1500,0,1500,0,1488.25747133727,1,1500,0,0,0,0,1,0,-0.452721838048305
"Henry R.",1484.2503420887,1,1485.337222933,1,1500,0,1500,0,1500,0,1500,0,1500,0,1486.88003928272,1,1,0,-0.629986316452029,0,0,0
"Peralta J.",1487.4293063646,1,1500,0,1500,0,1488.96720627435,1,1500,0,1488.32119936745,1,1487.17461368437,1,1500,0,0,0,0,1,0,-0.502827745415914
"Gallardo Valles M.",1485.78467591749,2,1500,0,1500,0,1486.78704422993,2,1500,0,1485.67021465886,2,1486.84056449392,2,1500,0,0,0,0,2,0,-0.568612963300247
"Norby R.",1486.0229072824,1,1485.14447271415,1,1500,0,1500,0,1500,0,1500,0,1487.34466929773,1,1500,0,0,0,0,1,0,-0.559083708704105
"Gooding J.",1493.15908695386,1,1492.06966035658,1,1500,0,1500,0,1500,0,1500,0,1492.48418465154,1,1500,0,0,0,0,1,0,-0.273636521845773
"Ouahabi T.",1489.8086498166,1,1500,0,1500,0,1488.75342279908,1,1500,0,1488.22116422931,1,1489.77258751194,1,1500,0,0,0,0,1,0,-0.407654007336077
"Lopes H.",1490.41268602021,1,1500,0,1500,0,1490.60385596838,1,1500,0,1489.28492830537,1,1489.80155312264,1,1500,0,0,0,0,1,0,-0.383492559191702
"Mathieu P.",1482.71007611512,4,1492.4886555753,1,1496.58222771439,1,1486.4456407274,2,1500,0,1485.53943692159,3,1482.62953376603,3,1497.60366546609,1,1,0,-0.0225769769065201,3,0,-0.669019978488736
"Weinzierl J.",1485.57576098246,1,1500,0,1500,0,1486.99670644259,1,1500,0,1486.31404642957,1,1485.5446834192,1,1500,0,0,0,0,1,0,-0.576969560701671
"Delfino M.",1487.63559468596,1,1500,0,1500,0,1487.26896776358,1,1500,0,1487.30875592734,1,1500,0,1487.61392960784,1,1,0,-0.49457621256171,0,0,0
"Koderisch C.",1493.29560675009,1,1500,0,1487.43671580258,1,1500,0,1500,0,1492.42010143158,1,1492.38085705167,1,1500,0,0,0,0,1,0,-0.268175729996385
"Logtens P.",1485.27796736047,2,1500,0,1476.67850052586,2,1500,0,1500,0,1477.3485025054,2,1484.15199722362,2,1500,0,0,0,0,2,0,-0.588881305581399
"Moser F.",1482.18779382766,2,1487.5,1,1488.7783046609,1,1500,0,1500,0,1494.48293719868,1,1481.17454783944,2,1500,0,0,0,0,2,0,-0.712488246893754
"Andersson H.",1486.94928429644,1,1500,0,1500,0,1487.5,1,1500,0,1487.5,1,1487.5,1,1500,0,0,0,0,1,0,-0.522028628142376
"Prpic A.",1473.77201101143,2,1500,0,1500,0,1473.71437461593,2,1500,0,1472.74375882701,2,1474.71325241828,2,1500,0,0,0,0,2,0,-1.04911955954263
"Levinsky J.",1484.25100478427,1,1500,0,1500,0,1483.27636376288,1,1500,0,1484.40031782929,1,1483.79360387581,1,1500,0,0,0,0,1,0,-0.629959808629079
"Levine I.",1474.63798539539,2,1487.04783345211,1,1487.5,1,1500,0,1500,0,1487.28398172154,1,1473.81236393324,2,1500,0,0,0,0,2,0,-1.01448058418451
"Behrmann M.",1485.15492785779,1,1484.08546779075,1,1500,0,1500,0,1500,0,1500,0,1485.63342383417,1,1500,0,0,0,0,1,0,-0.59380288568839
"Ayala D.",1485.67294969754,1,1486.27850466771,1,1500,0,1500,0,1500,0,1500,0,1485.95949531721,1,1500,0,0,0,0,1,0,-0.573082012098503
"Neumuller I.",1486.4561313298,1,1500,0,1500,0,1487.33070699439,1,1500,0,1486.20672306221,1,1486.44333465748,1,1500,0,0,0,0,1,0,-0.541754746808076
"Yim R.",1486.20592000352,2,1484.03961727593,2,1500,0,1500,0,1500,0,1500,0,1491.63338231009,1,1490.31192789258,1,1,0,-0.275481150961785,1,0,-0.276282048897572
"Fyrstenberg M.",1473.38150208109,3,1500,0,1500,0,1472.65498146242,3,1500,0,1471.52872949266,3,1473.36867882041,3,1500,0,0,0,0,3,0,-1.06473991675658
"Matkowski M.",1478.47105399787,2,1500,0,1500,0,1480.99139995271,2,1500,0,1479.56851457999,2,1478.43174420501,2,1500,0,0,0,0,2,0,-0.861157840085072
"Urban F.",1474.09677346059,2,1500,0,1500,0,1473.12312889247,2,1500,0,1473.24791568492,2,1474.76668422518,2,1500,0,0,0,0,2,0,-1.03612906157654
"Carlson A.",1486.36121387959,1,1486.93469325497,1,1500,0,1500,0,1500,0,1500,0,1486.57308776841,1,1500,0,0,0,0,1,0,-0.545551444816207
"Quintero M.",1486.58943140432,1,1500,0,1500,0,1487.23731143526,1,1500,0,1487.17816044705,1,1487.14599375591,1,1500,0,0,0,0,1,0,-0.536422743827349
"Moraru G.",1476.95976757034,2,1500,0,1500,0,1478.0691625053,2,1500,0,1477.64566347969,2,1476.08344419872,2,1500,0,0,0,0,2,0,-0.921609297186464
"Ratiwatana S.",1487.09544473651,1,1487.68521520089,1,1500,0,1500,0,1500,0,1500,0,1487.11711149484,1,1500,0,0,0,0,1,0,-0.516182210539672
"Snobel P.",1465.27449570256,4,1469.30259354156,3,1489.45519505603,1,1500,0,1500,0,1489.60790927634,1,1483.89239843828,2,1472.99554238783,2,2,0,-0.808998507477964,2,0,-0.580021664419475
"Davletshin V.",1486.96473222892,1,1488.19190893981,1,1500,0,1500,0,1500,0,1500,0,1487.64313791055,1,1500,0,0,0,0,1,0,-0.521410710843395
"Andersen J.",1485.11670865682,1,1485.79743830862,1,1500,0,1500,0,1500,0,1500,0,1485.65019472726,1,1500,0,0,0,0,1,0,-0.595331653727369
"Mankad H.",1460.73298969889,3,1473.39076632751,2,1487.78472145478,1,1500,0,1500,0,1485.18048659991,1,1461.69164695677,3,1500,0,0,0,0,3,0,-1.57068041204451
"Ferrero J.",1477.47854423526,2,1487.56042695705,1,1500,0,1491.35441972643,1,1500,0,1491.10071865038,1,1477.40526692235,2,1500,0,0,0,0,2,0,-0.900858230589712
"Reichel A.",1493.72621690881,1,1493.34266230283,1,1500,0,1500,0,1500,0,1500,0,1493.93177793375,1,1500,0,0,0,0,1,0,-0.250951323647451
"Braga P.",1488.38639925044,1,1500,0,1500,0,1489.86675156435,1,1500,0,1489.5526693773,1,1488.95094011207,1,1500,0,0,0,0,1,0,-0.464544029982363
"Gallardo M.",1480.37302715049,2,1500,0,1500,0,1482.26262431067,2,1500,0,1481.5884926328,2,1480.57902694188,2,1500,0,0,0,0,2,0,-0.785078913980283
"Phillips T.",1492.04424616413,1,1490.83072800162,1,1500,0,1500,0,1500,0,1500,0,1490.94329495736,1,1500,0,0,0,0,1,0,-0.318230153434799
"Burniol G.",1477.35510099746,2,1500,0,1500,0,1476.56121309555,2,1500,0,1479.86582192729,2,1476.32800149787,2,1500,0,0,0,0,2,0,-0.905795960101562
"Matos-Gil I.",1487.16833253695,2,1500,0,1500,0,1485.08192923211,2,1500,0,1484.51304273199,2,1484.61605768689,2,1500,0,0,0,0,2,0,-0.513266698522107
"Haas P.",1488.16425988217,1,1500,0,1500,0,1487.85755343789,1,1500,0,1487.90509013275,1,1488.12936505615,1,1500,0,0,0,0,1,0,-0.473429604713218
"Ziadi M.",1448.72866275956,5,1500,0,1500,0,1448.0165505151,5,1500,0,1445.86358722007,5,1447.1882906548,5,1500,0,0,0,0,5,0,-2.05085348961764
"Fitz S.",1489.77433377658,1,1500,0,1488.09047218391,1,1500,0,1500,0,1489.47478194607,1,1489.45365539162,1,1500,0,0,0,0,1,0,-0.409026648936613
"Hellstrom M.",1487.37069624787,1,1500,0,1500,0,1486.39265550976,1,1500,0,1485.51248072655,1,1487.00293844812,1,1500,0,0,0,0,1,0,-0.505172150085171
"van der Meer N.",1490.66686175724,1,1500,0,1500,0,1491.43224966028,1,1500,0,1490.16239977629,1,1490.8445349529,1,1500,0,0,0,0,1,0,-0.373325529710473
"Cook L.",1486.97939611637,1,1486.40621035413,1,1500,0,1500,0,1500,0,1500,0,1486.67990160822,1,1500,0,0,0,0,1,0,-0.520824155345287
"Lu Y.",1453.52276267537,4,1453.49482259347,4,1500,0,1500,0,1500,0,1500,0,1451.54773906123,4,1500,0,0,0,0,4,0,-1.85908949298513
"Gimeno D.",1492.27389819422,1,1500,0,1500,0,1490.67503018653,1,1500,0,1491.86721147105,1,1491.67094919788,1,1500,0,0,0,0,1,0,-0.309044072231189
"Yoo D.",1487.77121775733,1,1500,0,1500,0,1488.85119837285,1,1500,0,1488.05585765287,1,1487.84939812135,1,1500,0,0,0,0,1,0,-0.489151289706924
"Benneteau A.",1487.21552633634,1,1488.05385859688,1,1500,0,1500,0,1500,0,1500,0,1500,0,1487.19706484445,1,1,0,-0.51137894654659,0,0,0
"Ionita V.",1467.4041019673,3,1500,0,1500,0,1466.26749742679,3,1500,0,1465.03676180618,3,1464.17590775021,3,1500,0,0,0,0,3,0,-1.30383592130789
"Bohane A.",1491.17833116444,1,1492.48058907183,1,1500,0,1500,0,1500,0,1500,0,1490.50202336678,1,1500,0,0,0,0,1,0,-0.352866753422564
"Pedroso A.",1492.98523977227,1,1492.60620432756,1,1500,0,1500,0,1500,0,1500,0,1493.55397108408,1,1500,0,0,0,0,1,0,-0.280590409109252
"Gruber K.",1491.50631603544,1,1491.50381328057,1,1500,0,1500,0,1500,0,1500,0,1491.12239000708,1,1500,0,0,0,0,1,0,-0.339747358582538
"Rascon T.",1491.30982180968,1,1490.13509702061,1,1500,0,1500,0,1500,0,1500,0,1490.30516021411,1,1500,0,0,0,0,1,0,-0.347607127612792
"Kimmich M.",1480.32963987257,3,1474.34832677033,3,1500,0,1500,0,1500,0,1500,0,1489.96766538729,1,1478.37692303226,2,2,0,-0.483440859778768,1,0,-0.303373545318264
"Abdulla M.",1492.13267479181,1,1488.34287802525,1,1500,0,1500,0,1500,0,1500,0,1491.96679144803,1,1500,0,0,0,0,1,0,-0.314693008327681
"Jones G.D.",1481.45007273154,2,1473.83939105075,2,1500,0,1500,0,1500,0,1500,0,1482.4564111711,2,1500,0,0,0,0,2,0,-0.741997090738274
"Bourgeois L.",1485.34939726697,2,1484.06550156906,2,1500,0,1500,0,1500,0,1500,0,1484.20975246315,2,1500,0,0,0,0,2,0,-0.586024109321217
"March O.",1485.88597671178,1,1486.65236473792,1,1500,0,1500,0,1500,0,1500,0,1500,0,1487.07506861623,1,1,0,-0.564560931528797,0,0,0
"Nunez E.",1487.81619073118,1,1487.47560453229,1,1500,0,1500,0,1500,0,1500,0,1488.67709592641,1,1500,0,0,0,0,1,0,-0.48735237075285
"Parada F.",1484.56168786132,2,1500,0,1500,0,1486.812955076,2,1500,0,1486.27766047961,2,1485.74814389622,2,1500,0,0,0,0,2,0,-0.617532485547296
"Harboe P.",1489.43415622963,1,1500,0,1500,0,1489.88435048754,1,1500,0,1489.91201728888,1,1489.26979103408,1,1500,0,0,0,0,1,0,-0.422633750814676
"Dailey Z.",1490.51772678935,1,1489.30926523956,1,1500,0,1500,0,1500,0,1500,0,1490.20627666589,1,1500,0,0,0,0,1,0,-0.379290928425823
"Minar J.",1486.60287639474,3,1483.07411956498,3,1500,0,1500,0,1500,0,1500,0,1490.19240387164,2,1485.8848313374,1,1,0,-0.188672108114915,2,0,-0.347212836095586
"Tecau H.",1487.94647981772,1,1488.2404794896,1,1500,0,1500,0,1500,0,1500,0,1487.38769486335,1,1500,0,0,0,0,1,0,-0.482140807291074
"Condor F.",1487.15576376756,1,1500,0,1500,0,1483.05865205699,1,1500,0,1483.51104750618,1,1487.67625969475,1,1500,0,0,0,0,1,0,-0.513769449297506
"Mirnegg M.",1491.17997980401,1,1500,0,1500,0,1488.93634475818,1,1500,0,1488.98536993935,1,1490.18780734211,1,1500,0,0,0,0,1,0,-0.352800807839507
"Uebel L.",1496.76555189951,1,1500,0,1487.81856465441,1,1500,0,1500,0,1497.09215434538,1,1496.87155435429,1,1500,0,0,0,0,1,0,-0.129377924019567
"Klein T.",1488.95304068903,1,1500,0,1487.68997910794,1,1500,0,1500,0,1488.39294321422,1,1488.97170211583,1,1500,0,0,0,0,1,0,-0.441878372438673
"Korteling S.",1490.84275834124,1,1500,0,1500,0,1490.95693038247,1,1500,0,1490.15072491318,1,1488.73674009004,1,1500,0,0,0,0,1,0,-0.36628966635053
"Thron A.",1476.15199713844,2,1483.98062637652,1,1500,0,1493.64555969381,1,1500,0,1493.46096564182,1,1476.58622731493,2,1500,0,0,0,0,2,0,-0.953920114462378
"Simmonds P.",1479.93668192442,3,1473.42710968944,3,1500,0,1500,0,1500,0,1500,0,1483.28885159116,2,1488.42391922078,1,1,0,-0.16444875106153,2,0,-0.63808397196181
"Clayton A.",1485.78157583855,1,1486.21788239625,1,1500,0,1500,0,1500,0,1500,0,1485.37984850648,1,1500,0,0,0,0,1,0,-0.568736966457945
"Bester P.",1463.69457511482,5,1463.04249294634,5,1500,0,1500,0,1500,0,1500,0,1463.04249853732,5,1500,0,0,0,0,5,0,-1.45221699540725
"Steckley R.",1486.92484556397,1,1487.79641373377,1,1500,0,1500,0,1500,0,1500,0,1487.54066411747,1,1500,0,0,0,0,1,0,-0.523006177441359
"Fruttero J.P.",1488.28701750249,1,1487.33230320493,1,1500,0,1500,0,1500,0,1500,0,1488.26999325036,1,1500,0,0,0,0,1,0,-0.468519299900392
"Chen T.",1474.74961655693,3,1474.28178513524,3,1500,0,1500,0,1500,0,1500,0,1474.12962252165,3,1500,0,0,0,0,3,0,-1.01001533772295
"Do M.Q.",1485.77315732456,1,1487.25239616703,1,1500,0,1500,0,1500,0,1500,0,1485.45710852239,1,1500,0,0,0,0,1,0,-0.569073707017517
"Sanchez de Luna J.A.",1492.74790764529,1,1500,0,1500,0,1490.33267624796,1,1500,0,1490.16317747108,1,1492.90923664675,1,1500,0,0,0,0,1,0,-0.290083694188277
"Ittogi T.",1488.23416600378,1,1487.82272873821,1,1500,0,1500,0,1500,0,1500,0,1488.17610917673,1,1500,0,0,0,0,1,0,-0.470633359848637
"Junaid R.",1481.82789306412,2,1493.56859526971,1,1487.41193867142,1,1500,0,1500,0,1487.51159453823,1,1481.55181831154,2,1500,0,0,0,0,2,0,-0.726884277435364
"Uppal V.",1485.59914568846,1,1485.5224693631,1,1500,0,1500,0,1500,0,1500,0,1486.10204042407,1,1500,0,0,0,0,1,0,-0.576034172461557
"Sultan-Khalfan A.",1488.43543408666,1,1488.78785102645,1,1500,0,1500,0,1500,0,1500,0,1487.51693310709,1,1500,0,0,0,0,1,0,-0.46258263653372
"King-Turner D.",1445.54711886106,6,1436.27340277468,6,1500,0,1500,0,1500,0,1500,0,1442.47546160102,6,1500,0,0,0,0,6,0,-2.17811524555742
"Adaktusson J.",1491.20977550623,1,1489.47809272088,1,1500,0,1500,0,1500,0,1500,0,1500,0,1485.53333148329,1,1,0,-0.351608979750795,0,0,0
"Van der Dium A.",1483.86450144992,1,1484.84373264655,1,1500,0,1500,0,1500,0,1500,0,1483.57345476704,1,1500,0,0,0,0,1,0,-0.64541994200303
"Granollers-Pujol M.",1491.53435644541,1,1500,0,1500,0,1486.50670364122,1,1500,0,1487.64370714874,1,1491.2576125049,1,1500,0,0,0,0,1,0,-0.338625742183755
"Salva B.",1443.92945517263,5,1474.31008108761,2,1500,0,1468.21356907437,3,1500,0,1467.31079189069,3,1444.32568976323,5,1500,0,0,0,0,5,0,-2.24282179309471
"Skoch D.",1470.3161110729,3,1490.24567897949,1,1500,0,1479.6987671465,2,1500,0,1479.43341161536,2,1470.06301258584,3,1500,0,0,0,0,3,0,-1.18735555708394
"Peric T.",1489.69204454229,1,1500,0,1500,0,1489.99151170836,1,1500,0,1489.49263094205,1,1489.51902213782,1,1500,0,0,0,0,1,0,-0.412318218308403
"Luque D.",1487.5,1,1500,0,1500,0,1487.5,1,1500,0,1487.5,1,1487.5,1,1500,0,0,0,0,1,0,-0.5
"Azzaro L.",1471.14384125596,3,1500,0,1500,0,1468.95372870607,3,1500,0,1469.50735116654,3,1469.94703596618,3,1500,0,0,0,0,3,0,-1.15424634976171
"Popp T.",1479.66012601603,2,1500,0,1500,0,1478.73318885729,2,1500,0,1478.53470327128,2,1480.43209633677,2,1500,0,0,0,0,2,0,-0.813594959358795
"Dorsch B.",1471.81402647455,3,1479.79887311483,2,1489.23252663341,1,1500,0,1500,0,1490.00709998078,1,1478.42522543437,2,1491.41809205219,1,1,0,-0.336655216964927,2,0,-0.790783724053145
"Roshardt R.",1477.55983728812,2,1500,0,1500,0,1478.03431407365,2,1500,0,1477.3691400535,2,1476.87807434826,2,1500,0,0,0,0,2,0,-0.897606508475286
"Vicente M.",1488.08464073222,1,1500,0,1500,0,1488.25519785075,1,1500,0,1486.43443026014,1,1488.76261429857,1,1500,0,0,0,0,1,0,-0.476614370711123
"Kutac R.",1486.90478027727,1,1500,0,1500,0,1487.9627921953,1,1500,0,1486.63615543802,1,1487.52278543399,1,1500,0,0,0,0,1,0,-0.523808788909146
"Patriarca D.",1487.5,1,1500,0,1500,0,1487.5,1,1500,0,1487.5,1,1487.5,1,1500,0,0,0,0,1,0,-0.5
"Sandbichler A.",1487.8566912187,1,1500,0,1500,0,1487.71129349899,1,1500,0,1487.9740780527,1,1487.80063006694,1,1500,0,0,0,0,1,0,-0.485732351252017
"Belic L.",1470.43940757084,3,1500,0,1500,0,1466.39976786496,3,1500,0,1468.300470544,3,1466.64993346937,3,1500,0,0,0,0,3,0,-1.18242369716656
"Panfil G.",1486.04064499323,1,1500,0,1500,0,1486.64451265735,1,1500,0,1486.30501726671,1,1485.66052753294,1,1500,0,0,0,0,1,0,-0.558374200270612
"Dev Varman S.",1464.02924397241,3,1466.22424000466,3,1500,0,1500,0,1500,0,1500,0,1464.90093618467,3,1500,0,0,0,0,3,0,-1.43883024110343
"Yu X.Y.",1471.02216307235,2,1471.86785297638,2,1500,0,1500,0,1500,0,1500,0,1470.80364735441,2,1500,0,0,0,0,2,0,-1.15911347710596
"Wang Y.Jr.",1487.05047029068,1,1487.05047029068,1,1500,0,1500,0,1500,0,1500,0,1487.05047029068,1,1500,0,0,0,0,1,0,-0.517981188372765
"Dolgopolov A.",1477.30705326005,2,1500,0,1500,0,1478.6893047734,2,1500,0,1476.83503479483,2,1478.34438551789,2,1500,0,0,0,0,2,0,-0.907717869597937
"Aranguren J.M.",1477.44346264927,2,1500,0,1500,0,1474.78967179698,2,1500,0,1475.18300882087,2,1477.47823336103,2,1500,0,0,0,0,2,0,-0.902261494029235
"Smit J.",1484.98851657634,1,1485.01524029539,1,1500,0,1500,0,1500,0,1500,0,1485.41188470813,1,1500,0,0,0,0,1,0,-0.600459336946386
"Wagh A.",1493.28856486571,1,1492.75215605887,1,1500,0,1500,0,1500,0,1500,0,1491.80261274713,1,1500,0,0,0,0,1,0,-0.268457405371594
"Chaen T.",1485.33288477292,1,1484.66624330778,1,1500,0,1500,0,1500,0,1500,0,1485.70759036249,1,1500,0,0,0,0,1,0,-0.586684609083298
"Fish A.",1491.63412034755,1,1492.71082223354,1,1500,0,1500,0,1500,0,1500,0,1491.69761370128,1,1500,0,0,0,0,1,0,-0.334635186097921
"Jun W.",1491.34056157073,1,1491.40785632153,1,1500,0,1500,0,1500,0,1500,0,1491.18190675733,1,1500,0,0,0,0,1,0,-0.346377537170766
"Echagaray B.",1469.10189995149,4,1492.69207043016,1,1500,0,1478.42342861567,3,1500,0,1477.04977747288,3,1476.13455345098,3,1488.62415612755,1,1,0,-0.280770499670569,3,0,-0.955153502269679
"Fornell M.",1484.67088053156,1,1500,0,1500,0,1484.73682318102,1,1500,0,1484.46345835828,1,1484.85287913131,1,1500,0,0,0,0,1,0,-0.613164778737704
"Dustov F.",1448.54205616541,7,1500,0,1478.02824283683,2,1453.42862492654,5,1500,0,1441.12911092221,7,1446.83296971395,7,1500,0,0,0,0,7,0,-2.05831775338361
"Chaki R.",1481.75364452226,2,1500,0,1500,0,1481.0278527339,2,1500,0,1480.93080802274,2,1481.2738437691,2,1500,0,0,0,0,2,0,-0.729854219109781
"Sousa P.",1452.05483539606,5,1500,0,1500,0,1450.15572324346,5,1500,0,1450.34975877345,5,1450.30864239484,5,1500,0,0,0,0,5,0,-1.91780658415753
"Eysseric J.",1470.78308913839,3,1500,0,1500,0,1464.38505050291,3,1500,0,1466.28936100312,3,1487.11014054525,1,1476.47578208218,2,2,0,-0.68052130342745,1,0,-0.488155131037014
"Nielsen F.",1402.44632564992,10,1432.08710042067,6,1463.2989389956,3,1492.4107229268,1,1500,0,1457.97856101096,4,1404.05161648157,9,1487.10562031871,1,1,0,-0.1646414796125,9,0,-3.73750549439069
"Koning M.",1495.83287333378,1,1500,0,1488.99006206777,1,1500,0,1500,0,1495.26283297902,1,1494.77414978246,1,1500,0,0,0,0,1,0,-0.166685066648952
"Guzman J.",1487.92792054905,1,1500,0,1487.24830675123,1,1500,0,1500,0,1488.00281996885,1,1500,0,1488.94271958484,1,1,0,-0.482883178038082,0,0,0
"Goransson T.",1472.9067179169,2,1500,0,1500,0,1472.84043814083,2,1500,0,1472.33930883672,2,1473.28494478901,2,1500,0,0,0,0,2,0,-1.08373128332412
"Tveit E.",1492.24161843824,1,1500,0,1500,0,1492.42607010626,1,1500,0,1492.78449313868,1,1490.16694908518,1,1500,0,0,0,0,1,0,-0.310335262470239
"Ruevski P.",1487.24408716422,1,1500,0,1500,0,1487.14846378237,1,1500,0,1487.13233421201,1,1487.24447935512,1,1500,0,0,0,0,1,0,-0.51023651343127
"Olejniczak D.",1471.54655591699,3,1500,0,1487.87321735386,1,1480.95119710382,2,1500,0,1473.20035524983,3,1477.57944679942,2,1487.34763907993,1,1,0,-0.241546456215609,2,0,-0.896591307104792
"McClune M.",1493.65688462406,1,1492.94311180425,1,1500,0,1500,0,1500,0,1500,0,1500,0,1488.62247605027,1,1,0,-0.253724615037804,0,0,0
"Gard C.",1488.74285005252,1,1500,0,1500,0,1487.61536570141,1,1500,0,1487.56483065257,1,1488.7060684185,1,1500,0,0,0,0,1,0,-0.450285997899161
"Martin D.",1494.60338193398,1,1491.76539085476,1,1500,0,1500,0,1500,0,1500,0,1493.17792940676,1,1500,0,0,0,0,1,0,-0.215864722640768
"Wachiramanowong K.",1483.70147115277,3,1477.30184674239,3,1500,0,1500,0,1500,0,1500,0,1480.71241225043,3,1500,0,0,0,0,3,0,-0.651941153889381
"Siriluethaiwattana P.",1479.26710052867,2,1476.87474328669,2,1500,0,1500,0,1500,0,1500,0,1479.30379121486,2,1500,0,0,0,0,2,0,-0.829315978853338
"Singh N.",1487.82314979363,1,1487.69540757581,1,1500,0,1500,0,1500,0,1500,0,1487.81704070592,1,1500,0,0,0,0,1,0,-0.487074008254891
"Raja P.",1487.3275710455,1,1486.39500660787,1,1500,0,1500,0,1500,0,1500,0,1487.71010563608,1,1500,0,0,0,0,1,0,-0.506897158179862
"Nam H.W.",1472.13790547032,2,1472.76350156946,2,1500,0,1500,0,1500,0,1500,0,1472.60156465169,2,1500,0,0,0,0,2,0,-1.11448378118708
"Vardhan V.",1480.82815115504,2,1478.6984194319,2,1500,0,1500,0,1500,0,1500,0,1479.8233561347,2,1500,0,0,0,0,2,0,-0.766873953798277
"Haji A.",1487.79097830747,1,1487.87648894653,1,1500,0,1500,0,1500,0,1500,0,1487.84051510136,1,1500,0,0,0,0,1,0,-0.488360867701269
"Statham R.",1489.93010851338,1,1483.89784229254,1,1500,0,1500,0,1500,0,1500,0,1489.9748023125,1,1500,0,0,0,0,1,0,-0.402795659464908
"Podlipnik H.",1485.39906036439,2,1500,0,1500,0,1485.57949987605,2,1500,0,1485.31085974471,2,1484.66086269944,2,1500,0,0,0,0,2,0,-0.584037585424283
"Munoz de la Nava D.",1490.23825958571,1,1500,0,1500,0,1493.47344321343,1,1500,0,1492.92544110378,1,1490.92474290359,1,1500,0,0,0,0,1,0,-0.390469616571448
"Bowles C.",1488.4588683609,1,1488.29933064852,1,1500,0,1500,0,1500,0,1500,0,1487.51339923676,1,1500,0,0,0,0,1,0,-0.461645265564186
"Crugnola M.",1485.07073075372,3,1486.32114706832,2,1500,0,1494.52045917511,1,1500,0,1494.4679346452,1,1487.74998968897,2,1495.087822234,1,1,0,-0.157532971318232,2,0,-0.43963779853283
"Rodriguez B.",1487.04163942905,1,1500,0,1500,0,1487.68115298131,1,1500,0,1487.30399471052,1,1487.75394410091,1,1500,0,0,0,0,1,0,-0.518334422838035
"Ramirez C.",1476.1462229474,3,1500,0,1500,0,1479.30888848929,3,1500,0,1478.0111161994,3,1475.07777537631,3,1500,0,0,0,0,3,0,-0.954151082104009
"Al-Ghareeb M.",1495.89279958256,1,1495.40026095966,1,1500,0,1500,0,1500,0,1500,0,1494.07603632839,1,1500,0,0,0,0,1,0,-0.164288016697524
"Nader M.",1486.79234913856,1,1487.15770405953,1,1500,0,1500,0,1500,0,1500,0,1486.80937347586,1,1500,0,0,0,0,1,0,-0.528306034457471
"Sanchez De Luna J.",1486.93509577396,2,1500,0,1500,0,1484.45138567939,2,1500,0,1482.38845546492,2,1485.98740663043,2,1500,0,0,0,0,2,0,-0.522596169041533
"Marrai M.",1488.13794980593,1,1500,0,1500,0,1490.73132671188,1,1500,0,1490.04204373105,1,1488.1367390681,1,1500,0,0,0,0,1,0,-0.474482007762903
"Lipsky S.",1485.10770490395,1,1500,0,1487.81234042519,1,1500,0,1500,0,1487.19293155942,1,1485.35894640092,1,1500,0,0,0,0,1,0,-0.595691803842098
"Middelkoop M.",1489.00317760454,1,1500,0,1486.78578556259,1,1500,0,1500,0,1488.40424154335,1,1488.10123849239,1,1500,0,0,0,0,1,0,-0.439872895818523
"Slabinsky A.",1481.86798139788,2,1500,0,1474.72630173157,2,1500,0,1500,0,1475.05612885759,2,1481.42908422104,2,1500,0,0,0,0,2,0,-0.725280744084951
"Kim K",1495.9790678164,1,1500,0,1489.8534301547,1,1500,0,1500,0,1492.70017508859,1,1500,0,1487.76598744746,1,1,0,-0.160837287343993,0,0,0
"Brizzi A.",1486.15333403613,1,1500,0,1500,0,1486.6777383735,1,1500,0,1486.48923178663,1,1485.92141530852,1,1500,0,0,0,0,1,0,-0.553866638554873
"Matsukevitch D.",1488.28418598128,1,1500,0,1500,0,1489.39841166557,1,1500,0,1488.67604008383,1,1488.1732897461,1,1500,0,0,0,0,1,0,-0.468632560748931
"O'Neal J.",1484.42685820208,1,1485.09134822769,1,1500,0,1500,0,1500,0,1500,0,1485.53441320138,1,1500,0,0,0,0,1,0,-0.622925671916915
"Piccari F.",1484.42672988053,1,1500,0,1500,0,1485.64360283238,1,1500,0,1486.20012897624,1,1484.87742870826,1,1500,0,0,0,0,1,0,-0.622930804778619
"Estrella V.",1495.97742860408,1,1491.83708957722,1,1500,0,1500,0,1500,0,1500,0,1494.90203934818,1,1500,0,0,0,0,1,0,-0.160902855836942
"Ignatik U.",1490.14427212615,1,1489.7957574298,1,1500,0,1500,0,1500,0,1500,0,1489.36514596834,1,1500,0,0,0,0,1,0,-0.394229114953952
"Djokovic M.",1455.41007587186,4,1478.5792275116,2,1500,0,1476.88217876128,2,1500,0,1476.50274147599,2,1453.98356745575,4,1500,0,0,0,0,4,0,-1.78359696512575
"Xu J.C.",1485.60330084943,1,1486.15247911941,1,1500,0,1500,0,1500,0,1500,0,1486.42339484086,1,1500,0,0,0,0,1,0,-0.57586796602278
"Ito Y.",1487.27209025126,1,1487.38149305914,1,1500,0,1500,0,1500,0,1500,0,1487.58346081174,1,1500,0,0,0,0,1,0,-0.509116389949431
"Hajji A.",1478.1771932375,2,1477.56020143165,2,1500,0,1500,0,1500,0,1500,0,1478.073644359,2,1500,0,0,0,0,2,0,-0.872912270499928
"Ebelthite C.",1487.58597709097,1,1487.65036415981,1,1500,0,1500,0,1500,0,1500,0,1500,0,1487.65798831833,1,1,0,-0.49656091636129,0,0,0
"Anderson A.",1494.92001716942,1,1493.10141754272,1,1500,0,1500,0,1500,0,1500,0,1493.43443145959,1,1500,0,0,0,0,1,0,-0.203199313223102
"Hutchins R.",1487.69791654206,1,1487.16046836269,1,1500,0,1500,0,1500,0,1500,0,1488.37271449344,1,1500,0,0,0,0,1,0,-0.492083338317742
"Hocevar R.",1449.08638929943,5,1494.09735148564,1,1500,0,1456.79564662302,4,1500,0,1454.77070931362,4,1453.66480779375,4,1495.96701335892,1,1,0,-0.138211065367533,4,0,-1.89833336265545
"Silva D.",1486.43274110011,1,1500,0,1500,0,1487.3155513904,1,1500,0,1487.3252276065,1,1486.49606235465,1,1500,0,0,0,0,1,0,-0.542690355995559
"Poerschke L.",1484.45147460579,2,1483.64391626906,2,1500,0,1500,0,1500,0,1500,0,1482.65944176589,2,1500,0,0,0,0,2,0,-0.621941015768566
"Munoz de La Nava D.",1493.61589579274,1,1500,0,1500,0,1493.64106901459,1,1500,0,1493.48439555519,1,1493.59870867652,1,1500,0,0,0,0,1,0,-0.255364168290254
"King E.",1486.26868245958,1,1486.18727195802,1,1500,0,1500,0,1500,0,1500,0,1486.14564416214,1,1500,0,0,0,0,1,0,-0.549252701616858
"Riba-Madrid P.",1475.33677081708,2,1500,0,1484.87468601074,1,1487.86840554088,1,1500,0,1470.2253505751,2,1488.26024476415,1,1484.65602856056,1,1,0,-0.51946543858156,1,0,-0.46706372873539
"Zlatanovic A.",1486.67667170813,1,1500,0,1500,0,1486.46749040899,1,1500,0,1486.08018669244,1,1485.85937522603,1,1500,0,0,0,0,1,0,-0.532933131674777
"Kloer S.",1494.56454753407,1,1500,0,1500,0,1492.38853730251,1,1500,0,1493.99555052724,1,1493.86272362399,1,1500,0,0,0,0,1,0,-0.217418098637212
"Fleming C.",1482.12656680628,2,1500,0,1477.34985559237,2,1500,0,1500,0,1478.77676139497,2,1482.09965081083,2,1500,0,0,0,0,2,0,-0.71493732774867
"Berta D.",1471.61259203014,2,1500,0,1486.51856773275,1,1486.20791745562,1,1500,0,1469.16670379289,2,1472.07352443121,2,1500,0,0,0,0,2,0,-1.1354963187945
"Ghedin R.",1470.97281792507,3,1487.90931802794,1,1477.5058493606,2,1500,0,1500,0,1477.99559978283,2,1479.52270446804,2,1490.12235463472,1,1,0,-0.377233748848567,2,0,-0.783853534148649
"Krawietz K.",1473.89245506468,3,1500,0,1500,0,1467.31445743058,3,1500,0,1468.94555418168,3,1474.14312325239,3,1500,0,0,0,0,3,0,-1.04430179741297
"Britton D.",1483.4963230706,3,1479.12907913421,3,1500,0,1500,0,1500,0,1500,0,1483.15124354821,2,1499.11281634414,1,1,0,-0.0220574905042535,2,0,-0.638089586671644
"Agostinelli B.",1485.3269569376,1,1485.84881688823,1,1500,0,1500,0,1500,0,1500,0,1485.78230997636,1,1500,0,0,0,0,1,0,-0.586921722495883
"Buchanan C.",1487.09859575978,2,1486.88566024955,2,1500,0,1500,0,1500,0,1500,0,1490.2795848493,1,1492.66861865767,1,1,0,-0.145376271823296,1,0,-0.370679897785511
"Luncanu P.A.",1481.72087138562,2,1490.45624812181,1,1500,0,1487.24391095968,1,1500,0,1487.48038422215,1,1480.79328706889,2,1500,0,0,0,0,2,0,-0.731165144575288
"Valent R.",1491.3305823347,1,1489.4783982188,1,1500,0,1500,0,1500,0,1500,0,1490.03688584844,1,1500,0,0,0,0,1,0,-0.346776706612024
"Gong M.X.",1477.26659770262,4,1474.28663882059,4,1500,0,1500,0,1500,0,1500,0,1473.84636432978,4,1500,0,0,0,0,4,0,-0.909336091895187
"Biryukov M.",1477.09035996745,2,1473.54423643682,2,1500,0,1500,0,1500,0,1500,0,1477.81921413758,2,1500,0,0,0,0,2,0,-0.916385601301934
"Vovk S.",1487.80554551099,1,1487.97991633598,1,1500,0,1500,0,1500,0,1500,0,1488.21632293203,1,1500,0,0,0,0,1,0,-0.487778179560512
"Karlovic I. ",1487.5,1,1487.5,1,1500,0,1500,0,1500,0,1500,0,1487.5,1,1500,0,0,0,0,1,0,-0.5
"Bohli S. ",1487.5,1,1487.5,1,1500,0,1500,0,1500,0,1500,0,1487.5,1,1500,0,0,0,0,1,0,-0.5
"Rochus O. ",1487.5,1,1487.5,1,1500,0,1500,0,1500,0,1500,0,1487.5,1,1500,0,0,0,0,1,0,-0.5
"Schuettler R. ",1487.5,1,1487.5,1,1500,0,1500,0,1500,0,1500,0,1487.5,1,1500,0,0,0,0,1,0,-0.5
"Luczak P. ",1487.5,1,1487.5,1,1500,0,1500,0,1500,0,1500,0,1487.5,1,1500,0,0,0,0,1,0,-0.5
"Kohlschreiber P. ",1487.5,1,1487.5,1,1500,0,1500,0,1500,0,1500,0,1487.5,1,1500,0,0,0,0,1,0,-0.5
"Bolelli S. ",1487.5,1,1487.5,1,1500,0,1500,0,1500,0,1500,0,1487.5,1,1500,0,0,0,0,1,0,-0.5
"Becker B. ",1487.5,1,1487.5,1,1500,0,1500,0,1500,0,1500,0,1487.5,1,1500,0,0,0,0,1,0,-0.5
"Beck A. ",1487.5,1,1487.5,1,1500,0,1500,0,1500,0,1500,0,1487.5,1,1500,0,0,0,0,1,0,-0.5
"Benneteau J. ",1487.5,1,1487.5,1,1500,0,1500,0,1500,0,1500,0,1487.5,1,1500,0,0,0,0,1,0,-0.5
"Koellerer D. ",1487.5,1,1487.5,1,1500,0,1500,0,1500,0,1500,0,1487.5,1,1500,0,0,0,0,1,0,-0.5
"Petzschner P. ",1487.5,1,1487.5,1,1500,0,1500,0,1500,0,1500,0,1487.5,1,1500,0,0,0,0,1,0,-0.5
"Zeballos H. ",1487.5,1,1487.5,1,1500,0,1500,0,1500,0,1500,0,1487.5,1,1500,0,0,0,0,1,0,-0.5
"Blake J. ",1487.5,1,1487.5,1,1500,0,1500,0,1500,0,1500,0,1487.5,1,1500,0,0,0,0,1,0,-0.5
"Ljubicic I. ",1487.5,1,1487.5,1,1500,0,1500,0,1500,0,1500,0,1487.5,1,1500,0,0,0,0,1,0,-0.5
"Gonzalez F. ",1487.5,1,1487.5,1,1500,0,1500,0,1500,0,1500,0,1487.5,1,1500,0,0,0,0,1,0,-0.5
"Bautista R. ",1487.5,1,1487.5,1,1500,0,1500,0,1500,0,1500,0,1487.5,1,1500,0,0,0,0,1,0,-0.5
"Mathieu P.H. ",1487.5,1,1487.5,1,1500,0,1500,0,1500,0,1500,0,1487.5,1,1500,0,0,0,0,1,0,-0.5
"Greul S. ",1487.5,1,1487.5,1,1500,0,1500,0,1500,0,1500,0,1487.5,1,1500,0,0,0,0,1,0,-0.5
"Falla A. ",1487.5,1,1487.5,1,1500,0,1500,0,1500,0,1500,0,1487.5,1,1500,0,0,0,0,1,0,-0.5
"Kunitsyn I. ",1487.5,1,1487.5,1,1500,0,1500,0,1500,0,1500,0,1487.5,1,1500,0,0,0,0,1,0,-0.5
"Granollers M. ",1487.5,1,1487.5,1,1500,0,1500,0,1500,0,1500,0,1487.5,1,1500,0,0,0,0,1,0,-0.5
"Vassallo-Arguello M. ",1487.5,1,1487.5,1,1500,0,1500,0,1500,0,1500,0,1487.5,1,1500,0,0,0,0,1,0,-0.5
"Almagro N. ",1487.5,1,1487.5,1,1500,0,1500,0,1500,0,1500,0,1487.5,1,1500,0,0,0,0,1,0,-0.5
"Andreev I. ",1487.5,1,1487.5,1,1500,0,1500,0,1500,0,1500,0,1487.5,1,1500,0,0,0,0,1,0,-0.5
"Ferrero J.C. ",1487.5,1,1487.5,1,1500,0,1500,0,1500,0,1500,0,1487.5,1,1500,0,0,0,0,1,0,-0.5
"Gimeno-Traver D. ",1487.5,1,1487.5,1,1500,0,1500,0,1500,0,1500,0,1487.5,1,1500,0,0,0,0,1,0,-0.5
"Rochus C. ",1487.5,1,1487.5,1,1500,0,1500,0,1500,0,1500,0,1487.5,1,1500,0,0,0,0,1,0,-0.5
"Tsonga J.W. ",1487.5,1,1487.5,1,1500,0,1500,0,1500,0,1500,0,1487.5,1,1500,0,0,0,0,1,0,-0.5
"Hanescu V. ",1487.5,1,1487.5,1,1500,0,1500,0,1500,0,1500,0,1487.5,1,1500,0,0,0,0,1,0,-0.5
"Martin A. ",1487.5,1,1487.5,1,1500,0,1500,0,1500,0,1500,0,1487.5,1,1500,0,0,0,0,1,0,-0.5
"Hernandez O. ",1487.5,1,1487.5,1,1500,0,1500,0,1500,0,1500,0,1487.5,1,1500,0,0,0,0,1,0,-0.5
"Yang T.H.",1473.76002334724,4,1467.63635102022,4,1500,0,1500,0,1500,0,1500,0,1471.99862241619,4,1500,0,0,0,0,4,0,-1.0495990661106
"Maamoun K.",1489.54056712079,1,1487.56921875904,1,1500,0,1500,0,1500,0,1500,0,1489.05251147368,1,1500,0,0,0,0,1,0,-0.418377315168532
"Lemke J.",1492.8407550292,1,1484.83084912996,1,1500,0,1500,0,1500,0,1500,0,1492.96638027011,1,1500,0,0,0,0,1,0,-0.286369798832022
"Saavedra Corvalan C.",1486.7824543658,1,1500,0,1500,0,1486.77082160333,1,1500,0,1485.4247191054,1,1486.85123844779,1,1500,0,0,0,0,1,0,-0.528701825368002
"Im K.T.",1486.91395290733,1,1487.01494519623,1,1500,0,1500,0,1500,0,1500,0,1486.84543857909,1,1500,0,0,0,0,1,0,-0.523441883706905
"Deheart R.",1486.46824667831,2,1485.49780957201,2,1500,0,1500,0,1500,0,1500,0,1486.16155025878,2,1500,0,0,0,0,2,0,-0.541270132867567
"Niland C.",1479.60101668337,3,1499.28037667847,1,1487.72473769939,1,1487.34699815186,1,1500,0,1475.09178079389,2,1489.99944068037,1,1484.92348139627,2,2,0,-0.429258311030534,1,0,-0.386701021634597
"Emmrich M.",1492.58181145092,1,1500,0,1490.34902344951,1,1500,0,1500,0,1490.41306004219,1,1492.70395044129,1,1500,0,0,0,0,1,0,-0.296727541963134
"Alcaide G.",1494.48222482061,1,1500,0,1489.62077253125,1,1500,0,1500,0,1492.3916475472,1,1500,0,1491.0399982006,1,1,0,-0.220711007175738,0,0,0
"Velotti A.",1474.01812966632,3,1500,0,1500,0,1473.0680795694,3,1500,0,1472.61319012485,3,1474.11533031291,3,1500,0,0,0,0,3,0,-1.03927481334724
"Lojda D.",1492.38153622395,1,1489.7330004535,1,1500,0,1500,0,1500,0,1500,0,1500,0,1489.18329224103,1,1,0,-0.304738551042107,0,0,0
"Si Y.M.",1486.97335492579,1,1487.01648636601,1,1500,0,1500,0,1500,0,1500,0,1486.97033287205,1,1500,0,0,0,0,1,0,-0.521065802968248
"Belyaev I.",1491.22841211577,1,1489.24823641815,1,1500,0,1500,0,1500,0,1500,0,1490.39275638861,1,1500,0,0,0,0,1,0,-0.350863515369314
"Muster T.",1470.72378244625,3,1474.71435368336,2,1500,0,1492.34844589961,1,1500,0,1494.39356713182,1,1470.88583030935,3,1500,0,0,0,0,3,0,-1.1710487021499
"Sabry S.",1486.85080220097,1,1487.53569960122,1,1500,0,1500,0,1500,0,1500,0,1486.45303211378,1,1500,0,0,0,0,1,0,-0.525967911961341
"Scholtz N.",1485.72342074572,1,1485.02168035855,1,1500,0,1500,0,1500,0,1500,0,1486.42035523348,1,1500,0,0,0,0,1,0,-0.571063170171102
"Rios F.",1486.99839814203,1,1500,0,1500,0,1488.06546504113,1,1500,0,1488.03214533291,1,1487.29185823876,1,1500,0,0,0,0,1,0,-0.520064074318958
"Romboli F.",1484.71269350004,1,1500,0,1500,0,1487.01618726314,1,1500,0,1486.3248710725,1,1485.76718055907,1,1500,0,0,0,0,1,0,-0.611492259998574
"Clezar G.",1415.51986524549,9,1485.79280619342,1,1500,0,1429.51345997842,8,1500,0,1427.76763954383,8,1426.33859315276,8,1487.77781232067,1,1,0,-0.421966176132289,8,0,-2.95723921404806
"Borvanov R.",1490.1281305621,1,1488.37598405383,1,1500,0,1500,0,1500,0,1500,0,1489.36319002816,1,1500,0,0,0,0,1,0,-0.394874777515964
"Galdon P.",1496.21119043934,1,1500,0,1500,0,1496.58303311372,1,1500,0,1496.2841019016,1,1495.27989402349,1,1500,0,0,0,0,1,0,-0.151552382426222
"Kumantsov A.",1476.66001179758,2,1474.90894420056,2,1500,0,1500,0,1500,0,1500,0,1477.02734582156,2,1500,0,0,0,0,2,0,-0.933599528096851
"Garza D.",1462.01941030294,4,1493.24828132807,1,1500,0,1465.86542076655,3,1500,0,1466.13905284563,3,1460.14075537333,4,1500,0,0,0,0,4,0,-1.51922358788257
"Sanchez M.",1485.65555880535,1,1500,0,1500,0,1486.05872988523,1,1500,0,1486.14374787788,1,1485.83634383798,1,1500,0,0,0,0,1,0,-0.573777647785998
"Awadhy O.",1481.49912329111,2,1480.76760900013,2,1500,0,1500,0,1500,0,1500,0,1480.9561466978,2,1500,0,0,0,0,2,0,-0.740035068355638
"Granollers Pujol G.",1488.80970646218,1,1500,0,1500,0,1489.31867018453,1,1500,0,1489.38845199587,1,1488.43155676638,1,1500,0,0,0,0,1,0,-0.447611741512606
"Granollers-Pujol G.",1480.56349145213,2,1500,0,1500,0,1482.20821500649,2,1500,0,1481.76652631624,2,1480.84774200715,2,1500,0,0,0,0,2,0,-0.777460341914696
"Cox D.",1448.5492794491,5,1500,0,1442.41700173364,5,1500,0,1500,0,1444.78160049437,5,1458.76297870127,3,1479.97811348885,2,2,0,-0.485759890071988,3,0,-1.57226893196405
"Golding O.",1465.56351671328,3,1500,0,1462.64914952982,3,1500,0,1500,0,1463.25939901099,3,1475.93613697806,2,1489.69092680092,1,1,0,-0.338472371278982,2,0,-1.03898696018966
"Kirillov E.",1491.07362273936,1,1500,0,1486.25601173249,1,1500,0,1500,0,1487.86429297821,1,1489.96044779945,1,1500,0,0,0,0,1,0,-0.357055090425483
"Walter L.",1485.78587784808,1,1500,0,1485.42666876562,1,1500,0,1500,0,1486.492309877,1,1486.45563178849,1,1500,0,0,0,0,1,0,-0.568564886076865
"Kern R.",1470.30836938396,3,1500,0,1500,0,1470.92901984347,3,1500,0,1470.80701409614,3,1468.31589595121,3,1500,0,0,0,0,3,0,-1.18766522464152
"Grigelis L.",1489.92901831388,1,1487.73990777469,1,1500,0,1500,0,1500,0,1500,0,1488.50189593298,1,1500,0,0,0,0,1,0,-0.402839267444955
"Sitak A.",1484.86727636613,1,1484.43661159839,1,1500,0,1500,0,1500,0,1500,0,1485.25564750787,1,1500,0,0,0,0,1,0,-0.605308945354608
"Chvojka E.",1482.35592618027,2,1493.48364610487,1,1500,0,1489.64819147737,1,1500,0,1488.89655889794,1,1481.94401564858,2,1500,0,0,0,0,2,0,-0.705762952789243
"Torebko P.",1489.5817745503,1,1500,0,1500,0,1488.5250299151,1,1500,0,1488.24451236246,1,1489.2267814174,1,1500,0,0,0,0,1,0,-0.416729017988043
"Li Z.",1463.42959989014,5,1460.30288911996,5,1500,0,1500,0,1500,0,1500,0,1461.85709935526,5,1500,0,0,0,0,5,0,-1.46281600439454
"Nedelko I.",1478.8456367626,2,1474.71470520348,2,1500,0,1500,0,1500,0,1500,0,1478.50287825319,2,1500,0,0,0,0,2,0,-0.846174529496189
"Mitchell B.",1455.08349930769,5,1453.0250677218,5,1500,0,1500,0,1500,0,1500,0,1469.11709075876,3,1479.66949754975,2,2,0,-0.598071570731648,3,0,-1.19858845696086
"Al Mutawa J.",1487.36961719266,1,1487.72674195148,1,1500,0,1500,0,1500,0,1500,0,1486.39949486496,1,1500,0,0,0,0,1,0,-0.505215312293445
"Viola Mat.",1483.42847327806,2,1477.82041816681,2,1500,0,1500,0,1500,0,1500,0,1489.13201845507,1,1485.20886597436,1,1,0,-0.298318977800893,1,0,-0.364542091076652
"Van D. Merwe I.",1485.63068453067,1,1485.7178475425,1,1500,0,1500,0,1500,0,1500,0,1486.08887459159,1,1500,0,0,0,0,1,0,-0.574772618773375
"Mesaros K.",1491.41494121412,1,1488.58359065218,1,1500,0,1500,0,1500,0,1500,0,1490.54334089806,1,1500,0,0,0,0,1,0,-0.343402351435097
"Marcan D.",1484.56588591043,2,1481.16483420297,2,1500,0,1500,0,1500,0,1500,0,1483.99188733079,2,1500,0,0,0,0,2,0,-0.617364563582902
"Lajola D.",1487.5,1,1487.5,1,1500,0,1500,0,1500,0,1500,0,1487.5,1,1500,0,0,0,0,1,0,-0.5
"Strode B.",1487.94952970932,1,1487.94952970932,1,1500,0,1500,0,1500,0,1500,0,1487.94952970932,1,1500,0,0,0,0,1,0,-0.482018811627235
"Molteni A.",1485.75134813946,2,1500,0,1500,0,1485.20840975029,2,1500,0,1485.13744000084,2,1485.62745670811,2,1500,0,0,0,0,2,0,-0.569946074421473
"Cabal J.S.",1476.40496018544,2,1500,0,1500,0,1474.86880727251,2,1500,0,1474.97533364929,2,1476.77022611342,2,1500,0,0,0,0,2,0,-0.943801592582448
"Idmbarek Y.",1480.56727052814,2,1500,0,1500,0,1478.3028533325,2,1500,0,1479.33974909075,2,1479.3308244137,2,1500,0,0,0,0,2,0,-0.777309178874416
"Gomez-Herrera C.",1489.33018450593,1,1500,0,1500,0,1489.49527255038,1,1500,0,1489.15020747647,1,1489.26521319439,1,1500,0,0,0,0,1,0,-0.426792619762914
"Trusendi W.",1486.91944702006,1,1500,0,1500,0,1485.39004406515,1,1500,0,1486.31062284967,1,1486.77271827141,1,1500,0,0,0,0,1,0,-0.523222119197776
"Ehrat S.",1483.72928542168,1,1500,0,1500,0,1484.95403566418,1,1500,0,1484.91798171663,1,1484.0803308798,1,1500,0,0,0,0,1,0,-0.650828583132823
"Meister N.",1492.5413588699,1,1488.27808355432,1,1500,0,1500,0,1500,0,1500,0,1491.34275409133,1,1500,0,0,0,0,1,0,-0.298345645204091
"Authom M.",1476.39016038699,2,1472.63979299823,2,1500,0,1500,0,1500,0,1500,0,1500,0,1468.1964477829,2,2,0,-0.944393584520438,0,0,0
"Vasilevski A.",1487.59235419636,1,1487.89339043685,1,1500,0,1500,0,1500,0,1500,0,1487.36940372198,1,1500,0,0,0,0,1,0,-0.496305832145529
"Betov S.",1485.49351675258,1,1484.75457060138,1,1500,0,1500,0,1500,0,1500,0,1485.86799481738,1,1500,0,0,0,0,1,0,-0.580259329896861
"Fidirko N.",1486.88531036426,1,1485.36251932535,1,1500,0,1500,0,1500,0,1500,0,1487.28410026604,1,1500,0,0,0,0,1,0,-0.524587585429568
"Deen Heshaam A.",1488.06044414592,1,1487.79854682404,1,1500,0,1500,0,1500,0,1500,0,1488.15727865521,1,1500,0,0,0,0,1,0,-0.477582234163097
"Inglot D.",1484.83560752289,2,1477.52509652882,2,1500,0,1500,0,1500,0,1500,0,1485.08014299071,2,1500,0,0,0,0,2,0,-0.606575699084441
"Singh S.",1493.83500200114,1,1494.31631225195,1,1500,0,1500,0,1500,0,1500,0,1493.92977143927,1,1500,0,0,0,0,1,0,-0.246599919954422
"Ali Mutawa J.M.",1477.38526208464,2,1475.68498545777,2,1500,0,1500,0,1500,0,1500,0,1476.95720196982,2,1500,0,0,0,0,2,0,-0.904589516614516
"Zayed M. S.",1496.35021127788,1,1496.25972388632,1,1500,0,1500,0,1500,0,1500,0,1496.25242363805,1,1500,0,0,0,0,1,0,-0.145991548884906
"Veger F.",1490.50243374539,1,1486.77359187059,1,1500,0,1500,0,1500,0,1500,0,1489.13901045215,1,1500,0,0,0,0,1,0,-0.379902650184291
"Reyes-Varela M.A.",1480.64986709019,2,1491.31509183666,1,1500,0,1490.18565140333,1,1500,0,1489.90096577682,1,1478.5806991911,2,1500,0,0,0,0,2,0,-0.77400531639224
"Rachidi Y.",1486.92388676607,1,1500,0,1500,0,1487.16296123018,1,1500,0,1487.14572137607,1,1486.83568872877,1,1500,0,0,0,0,1,0,-0.523044529357297
"Granollers G.",1486.82847373547,1,1500,0,1500,0,1487.33406565292,1,1500,0,1487.29865769593,1,1486.78647960965,1,1500,0,0,0,0,1,0,-0.526861050581355
"Desein N.",1469.16598300011,3,1489.41586246234,1,1486.24078277219,1,1488.70273276721,1,1500,0,1473.99637954599,2,1477.78856808882,2,1488.05505444584,1,1,0,-0.340899992167419,2,0,-0.892460687828139
"Corrie E.",1489.13863410681,1,1500,0,1487.3555602283,1,1500,0,1500,0,1486.63409679012,1,1489.06537059314,1,1500,0,0,0,0,1,0,-0.434454635727577
"Reid M.",1494.11053413315,1,1500,0,1492.22842400452,1,1500,0,1500,0,1492.21745587539,1,1500,0,1490.35911631671,1,1,0,-0.235578634674084,0,0,0
"Eriksson M.",1454.33003236011,4,1485.9235219971,1,1500,0,1468.04394379533,3,1500,0,1465.52976535834,3,1453.70324316232,4,1500,0,0,0,0,4,0,-1.82679870559555
"Bossel A.",1476.40079904546,2,1500,0,1476.45880198446,2,1500,0,1500,0,1477.07181561605,2,1475.02143151919,2,1500,0,0,0,0,2,0,-0.943968038181472
"Ward A.",1477.36248653633,3,1500,0,1476.7455300099,2,1493.32963724077,1,1500,0,1474.8044115062,3,1480.76131510605,2,1492.14349363384,1,1,0,-0.104830125586318,2,0,-0.800670412960435
"Salamanca C.",1489.78428596034,1,1500,0,1500,0,1488.87951253558,1,1500,0,1488.78201548288,1,1489.91991224899,1,1500,0,0,0,0,1,0,-0.408628561586589
"Barrientos N.",1457.39931946289,3,1500,0,1500,0,1462.10043739133,3,1500,0,1460.69291526546,3,1457.80434445642,3,1500,0,0,0,0,3,0,-1.70402722148453
"Londero J.I.",1477.92083791261,2,1500,0,1500,0,1475.189635863,2,1500,0,1477.19698697886,2,1478.52628443095,2,1500,0,0,0,0,2,0,-0.883166483495491
"Struvay E.",1475.90024554453,2,1500,0,1500,0,1477.07040348626,2,1500,0,1476.23268914706,2,1476.11477131191,2,1500,0,0,0,0,2,0,-0.963990178218709
"King K.",1481.37916199689,2,1488.73128043191,1,1500,0,1490.14059584567,1,1500,0,1489.24245581282,1,1480.55157339798,2,1500,0,0,0,0,2,0,-0.744833520124384
"Westerhof B.",1487.8103533963,1,1500,0,1500,0,1486.47955178085,1,1500,0,1486.35594808848,1,1488.31343334738,1,1500,0,0,0,0,1,0,-0.487585864147871
"Topic J.",1492.26360251556,1,1500,0,1500,0,1492.15139686155,1,1500,0,1491.25373003433,1,1492.42179300598,1,1500,0,0,0,0,1,0,-0.309455899377606
"Setkic A.",1480.36682194555,2,1500,0,1500,0,1480.30791137298,2,1500,0,1480.66092028361,2,1479.32283830847,2,1500,0,0,0,0,2,0,-0.785327122177813
"Mcdonald M.",1452.17205253341,4,1464.47698910039,3,1489.00116532838,1,1500,0,1500,0,1487.8264591216,1,1462.59057140317,3,1487.5,1,1,0,-0.456458671160761,3,0,-1.45665922750265
"Bogaerts R.",1490.05348886392,1,1487.88770853855,1,1500,0,1500,0,1500,0,1500,0,1489.03556729338,1,1500,0,0,0,0,1,0,-0.397860445443274
"Altamirano C.",1494.68015436215,1,1492.92501461423,1,1500,0,1500,0,1500,0,1500,0,1500,0,1492.27817427136,1,1,0,-0.212793825514105,0,0,0
"Djere L.",1472.19888363171,3,1492.87424707345,1,1500,0,1477.26805670043,2,1500,0,1477.14729169796,2,1483.07705367825,2,1486.3272704393,1,1,0,-0.494099979266597,2,0,-0.617944675465084
"Trongcharoenchaikul W.",1490.7378638417,1,1490.70848245706,1,1500,0,1500,0,1500,0,1500,0,1491.23013865884,1,1500,0,0,0,0,1,0,-0.370485446332161
"Jeong S.Y.",1492.72799047103,1,1492.67904919332,1,1500,0,1500,0,1500,0,1500,0,1491.12804332581,1,1500,0,0,0,0,1,0,-0.29088038115899
"Nedovyesov O.",1487.3099152809,1,1488.23829716937,1,1500,0,1500,0,1500,0,1500,0,1487.01471668845,1,1500,0,0,0,0,1,0,-0.50760338876408
"Sekulic M.",1486.52202896671,1,1486.66301821845,1,1500,0,1500,0,1500,0,1500,0,1486.93117817133,1,1500,0,0,0,0,1,0,-0.539118841331401
"Nedunchezhiyan J.",1485.78915286706,1,1486.1654654476,1,1500,0,1500,0,1500,0,1500,0,1486.37807559772,1,1500,0,0,0,0,1,0,-0.568433885317751
"Zayed M.S.",1499.04660052928,1,1498.752634143,1,1500,0,1500,0,1500,0,1500,0,1498.37510332629,1,1500,0,0,0,0,1,0,-0.0381359788289566
"Hossam K.",1497.28243122454,1,1497.04239660238,1,1500,0,1500,0,1500,0,1500,0,1496.52566122104,1,1500,0,0,0,0,1,0,-0.108702751018465
"Struff J-L.",1496.9085149576,1,1495.97370731767,1,1500,0,1500,0,1500,0,1500,0,1496.51924218128,1,1500,0,0,0,0,1,0,-0.123659401695874
"Artunedo Martinavarro A.",1487.44845645417,1,1487.2974800958,1,1500,0,1500,0,1500,0,1500,0,1487.42494285644,1,1500,0,0,0,0,1,0,-0.502061741833126
"Lama G.",1486.39362302398,1,1500,0,1500,0,1488.43961774685,1,1500,0,1487.77603742025,1,1487.06854144755,1,1500,0,0,0,0,1,0,-0.54425507904079
"Krstin P.",1481.8418074295,2,1482.42434747718,2,1500,0,1500,0,1500,0,1500,0,1480.28865931765,2,1500,0,0,0,0,2,0,-0.726327702819981
"Hank T.",1472.62566432692,3,1471.80848409892,3,1500,0,1500,0,1500,0,1500,0,1471.30877045539,3,1500,0,0,0,0,3,0,-1.0949734269231
"Khaddari H.",1489.05470103814,1,1500,0,1500,0,1491.15824509165,1,1500,0,1490.80162828798,1,1488.53779896385,1,1500,0,0,0,0,1,0,-0.437811958474422
"Ciorcila P.",1489.54944329201,1,1500,0,1500,0,1485.71870747629,1,1500,0,1486.7210176748,1,1489.30321539794,1,1500,0,0,0,0,1,0,-0.418022268319717
"Travaglia S.",1488.83913404307,1,1500,0,1500,0,1488.66687185144,1,1500,0,1489.32531087598,1,1489.30755044675,1,1500,0,0,0,0,1,0,-0.446434638277352
"Vaisse M.",1491.47905579088,1,1500,0,1500,0,1485.10901783598,1,1500,0,1491.72871667711,1,1491.63146550757,1,1500,0,0,0,0,1,0,-0.340837768364729
"Lokoli L.",1456.94577050144,4,1464.7615116285,3,1500,0,1486.9185057054,1,1500,0,1486.52375132557,1,1478.36659235116,2,1472.51309225188,2,2,0,-0.949007971206812,2,0,-0.773161208735598
"Coppejans K.",1466.15283480608,4,1500,0,1492.25772661391,1,1471.45637016326,3,1500,0,1468.56897693317,4,1476.26324579322,3,1484.6865069249,1,1,0,-0.399630927789231,3,0,-0.954255679967596
"Smethurst D.",1496.31136660221,1,1500,0,1490.90286277132,1,1500,0,1500,0,1492.47708020944,1,1500,0,1492.17092058737,1,1,0,-0.147545335911662,0,0,0
"Thompson C.",1488.1322605426,1,1500,0,1486.9193179658,1,1500,0,1500,0,1486.87749361395,1,1488.42726790763,1,1500,0,0,0,0,1,0,-0.474709578296133
"Krueger M.",1485.65588229683,1,1500,0,1486.34871911721,1,1500,0,1500,0,1486.30125126281,1,1485.95765125229,1,1500,0,0,0,0,1,0,-0.573764708126664
"Pasha N.",1488.4755174036,1,1488.00592208211,1,1500,0,1500,0,1500,0,1500,0,1488.67319338789,1,1500,0,0,0,0,1,0,-0.460979303856126
"De Paula F.",1486.99305063068,1,1500,0,1500,0,1487.05047029068,1,1500,0,1486.81586543561,1,1486.37571653614,1,1500,0,0,0,0,1,0,-0.520277974772776
"Galovic V.",1491.18542005281,1,1500,0,1500,0,1491.35654326527,1,1500,0,1491.34939845502,1,1491.593508232,1,1500,0,0,0,0,1,0,-0.352583197887469
"Schnur B.",1492.30240017548,1,1491.44754057869,1,1500,0,1500,0,1500,0,1500,0,1491.40132605907,1,1500,0,0,0,0,1,0,-0.307903992980661
"Giron M.",1481.68803514368,2,1483.15749808819,2,1500,0,1500,0,1500,0,1500,0,1485.02982075353,1,1492.32994098156,1,1,0,-0.139637589526321,1,0,-0.5928410047264
"Mcgee J.",1467.19454794136,3,1467.75438556628,3,1500,0,1500,0,1500,0,1500,0,1478.90131265052,2,1487.16363913467,1,1,0,-0.581624568089789,2,0,-0.73059351425569
"Takeuchi K.",1486.24686217513,1,1486.04151980741,1,1500,0,1500,0,1500,0,1500,0,1486.25564954123,1,1500,0,0,0,0,1,0,-0.550125512994779
"Burquier G.",1492.29191806841,1,1485.74814416034,1,1500,0,1500,0,1500,0,1500,0,1492.02767046515,1,1500,0,0,0,0,1,0,-0.308323277263671
"Gao X.",1487.48114148516,1,1489.12991440492,1,1500,0,1500,0,1500,0,1500,0,1488.46034411789,1,1500,0,0,0,0,1,0,-0.50075434059363
"Ouyang B.",1491.86277553173,1,1486.60531232678,1,1500,0,1500,0,1500,0,1500,0,1492.08724103927,1,1500,0,0,0,0,1,0,-0.325488978730862
"Gerasimov E.",1487.21726748552,1,1487.0248792967,1,1500,0,1500,0,1500,0,1500,0,1486.61459518882,1,1500,0,0,0,0,1,0,-0.511309300579227
"Herbert P-H.",1487.18618136635,1,1486.82591223614,1,1500,0,1500,0,1500,0,1500,0,1487.04429844984,1,1500,0,0,0,0,1,0,-0.512552745346078
"Baluda V.",1493.59626862075,1,1493.21273575949,1,1500,0,1500,0,1500,0,1500,0,1493.55343370659,1,1500,0,0,0,0,1,0,-0.256149255170111
"Gombos N.",1476.81264078939,4,1478.64898009062,3,1500,0,1489.22061271455,1,1500,0,1488.60406567251,1,1474.68540429207,4,1500,0,0,0,0,4,0,-0.927494368424527
"Prashanth V.",1488.28478991446,1,1486.3374173007,1,1500,0,1500,0,1500,0,1500,0,1487.78424052167,1,1500,0,0,0,0,1,0,-0.468608403421721
"Escobar G.",1474.39808275474,2,1500,0,1500,0,1475.15581374727,2,1500,0,1474.08639754198,2,1475.03571007481,2,1500,0,0,0,0,2,0,-1.02407668981055
"Androic T.",1482.92838515911,2,1491.69844068416,1,1500,0,1489.1279656588,1,1500,0,1489.54578563503,1,1480.74594715692,2,1500,0,0,0,0,2,0,-0.682864593635496
"Quigley E.",1489.83821262997,1,1488.48690250694,1,1500,0,1500,0,1500,0,1500,0,1488.08302281828,1,1500,0,0,0,0,1,0,-0.406471494801387
"Martin F.",1476.29072239288,2,1485.45478905207,1,1487.71998047353,1,1500,0,1500,0,1487.53137143299,1,1476.50458117578,2,1500,0,0,0,0,2,0,-0.948371104284889
"Bolt A.",1488.3220500419,1,1486.06308440571,1,1500,0,1500,0,1500,0,1500,0,1488.35498449332,1,1500,0,0,0,0,1,0,-0.467117998324026
"Giustino L.",1482.1166443595,2,1500,0,1500,0,1481.17273753229,2,1500,0,1483.44934095604,2,1480.85696232819,2,1500,0,0,0,0,2,0,-0.715334225620136
"Silva F.",1485.83042737753,2,1500,0,1500,0,1481.11717793515,2,1500,0,1480.5760871097,2,1484.22279328986,2,1500,0,0,0,0,2,0,-0.566782904898947
"Lestienne C.",1486.53961266712,1,1500,0,1500,0,1486.61123932788,1,1500,0,1486.73258656475,1,1486.25110502666,1,1500,0,0,0,0,1,0,-0.538415493315365
"Vega Hernandez D.",1487.02222545361,1,1500,0,1500,0,1487.09158192461,1,1500,0,1487.20900637567,1,1486.74250987453,1,1500,0,0,0,0,1,0,-0.519110981855472
"Ilkel C.",1464.96669628771,4,1477.14237781369,2,1500,0,1481.99556879169,2,1500,0,1481.17108371304,2,1462.46555560009,4,1500,0,0,0,0,4,0,-1.40133214849174
"Gaio F.",1482.76798754381,2,1487.489619243,1,1500,0,1492.17590192971,1,1500,0,1492.51265501767,1,1481.28646469236,2,1500,0,0,0,0,2,0,-0.689280498247766
"Hamou M.",1480.95066630854,2,1500,0,1500,0,1475.41068003594,2,1500,0,1477.41957214288,2,1487.41962016798,1,1492.0200262118,1,1,0,-0.276773786364716,1,0,-0.485199561293717
"Gigounon G.",1496.98834381298,1,1500,0,1500,0,1495.62709746507,1,1500,0,1495.39587936953,1,1500,0,1494.72865073203,1,1,0,-0.120466247480717,0,0,0
"Marterer M.",1470.23248858266,4,1477.71362923062,2,1486.84014561609,1,1494.12759902202,1,1500,0,1482.54739117445,2,1468.78623986482,4,1500,0,0,0,0,4,0,-1.19070045669378
"Trevisan M.",1486.27750696441,1,1500,0,1500,0,1487.27056692095,1,1500,0,1486.1124833743,1,1486.7109393369,1,1500,0,0,0,0,1,0,-0.548899721423501
"Eubanks C.",1479.97059806159,2,1478.940052702,2,1500,0,1500,0,1500,0,1500,0,1480.30893112656,2,1500,0,0,0,0,2,0,-0.801176077536502
"King D.",1487.49118721366,1,1487.01464973823,1,1500,0,1500,0,1500,0,1500,0,1487.281805462,1,1500,0,0,0,0,1,0,-0.500352511453586
"Shane R.",1494.35847354204,1,1493.51078321112,1,1500,0,1500,0,1500,0,1500,0,1500,0,1492.26471058526,1,1,0,-0.225661058318572,0,0,0
"Shyla Y.",1490.94162890011,1,1487.54884123697,1,1500,0,1500,0,1500,0,1500,0,1489.23829630449,1,1500,0,0,0,0,1,0,-0.362334843995623
"Uchiyama Y.",1483.74422327173,2,1481.62860271407,2,1500,0,1500,0,1500,0,1500,0,1482.78915862532,2,1500,0,0,0,0,2,0,-0.650231069130898
"Niki T.",1487.58123652766,1,1487.5157950687,1,1500,0,1500,0,1500,0,1500,0,1487.51977058279,1,1500,0,0,0,0,1,0,-0.49675053889355
"Miedler L.",1490.24893579361,1,1490.14053579824,1,1500,0,1500,0,1500,0,1500,0,1491.03018887982,1,1500,0,0,0,0,1,0,-0.390042568255458
"Anderson O.",1490.5919800813,1,1489.81309981929,1,1500,0,1500,0,1500,0,1500,0,1490.56864440474,1,1500,0,0,0,0,1,0,-0.376320796748069
"Zayid M. S.",1494.14205305317,1,1493.05168012657,1,1500,0,1500,0,1500,0,1500,0,1492.60820049719,1,1500,0,0,0,0,1,0,-0.23431787787302
"Tearney F.",1492.26476763062,1,1492.44077040194,1,1500,0,1500,0,1500,0,1500,0,1490.7599209432,1,1500,0,0,0,0,1,0,-0.30940929477514
"Lazov A.",1490.80878320796,1,1488.70841369488,1,1500,0,1500,0,1500,0,1500,0,1490.64705449088,1,1500,0,0,0,0,1,0,-0.367648671681622
"Kuzmanov D.",1489.33333034521,1,1490.10824830513,1,1500,0,1500,0,1500,0,1500,0,1489.05352537292,1,1500,0,0,0,0,1,0,-0.426666786191595
"Mmoh M.",1472.92754481727,3,1470.09169750898,3,1500,0,1500,0,1500,0,1500,0,1481.41748082843,2,1493.13113030279,1,1,0,-0.342978652220905,2,0,-0.739919555088268
"Patino L.",1490.55051891447,1,1487.35986440526,1,1500,0,1500,0,1500,0,1500,0,1490.25162956527,1,1500,0,0,0,0,1,0,-0.37797924342132
"Gomez L.",1483.34034150165,2,1477.09686427048,2,1500,0,1500,0,1500,0,1500,0,1483.17745584402,2,1500,0,0,0,0,2,0,-0.666386339934171
"Ahouda A.",1488.90301604911,1,1500,0,1500,0,1489.57530839017,1,1500,0,1488.80632806667,1,1489.0331737771,1,1500,0,0,0,0,1,0,-0.443879358035407
"Cachin P.",1489.83220200857,1,1500,0,1500,0,1488.46632806169,1,1500,0,1490.87840250143,1,1490.23941458595,1,1500,0,0,0,0,1,0,-0.40671191965722
"Linzer M.",1478.90466748183,2,1500,0,1500,0,1477.5516734018,2,1500,0,1478.83469583417,2,1478.02784554316,2,1500,0,0,0,0,2,0,-0.843813300726691
"Caruso S.",1497.13357914109,1,1500,0,1500,0,1491.78295146512,1,1500,0,1493.60049872469,1,1495.88031510809,1,1500,0,0,0,0,1,0,-0.114656834356285
"Sonego L.",1492.94285173455,1,1500,0,1500,0,1491.14019425949,1,1500,0,1491.74021805228,1,1492.20130143005,1,1500,0,0,0,0,1,0,-0.282285930617928
"Ortega-Olmedo R.",1490.88089401272,1,1500,0,1500,0,1489.58579061505,1,1500,0,1489.65392548149,1,1489.87980342076,1,1500,0,0,0,0,1,0,-0.364764239491322
"Samper-Montana J.",1487.5,1,1500,0,1500,0,1487.5,1,1500,0,1487.5,1,1500,0,1487.5,1,1,0,-0.5,0,0,0
"Barrere G.",1484.62404910019,2,1486.58131564206,1,1500,0,1492.85935879235,1,1500,0,1493.34602765295,1,1487.69838744082,1,1491.3573007936,1,1,0,-0.126874171280957,1,0,-0.48816386471131
"Choinski J.",1490.37114075412,1,1500,0,1488.05651657188,1,1500,0,1500,0,1487.87810338731,1,1489.89763472706,1,1500,0,0,0,0,1,0,-0.385154369835192
"Arvidsson I.",1490.25113379802,1,1500,0,1500,0,1487.58940971391,1,1500,0,1487.91517801247,1,1489.54472005898,1,1500,0,0,0,0,1,0,-0.389954648079075
"Simonsson F.",1487.5,1,1500,0,1500,0,1487.5,1,1500,0,1487.5,1,1487.5,1,1500,0,0,0,0,1,0,-0.5
"Moeller M.",1490.28628219703,1,1500,0,1500,0,1488.03084535921,1,1500,0,1489.10139344137,1,1488.90923256311,1,1500,0,0,0,0,1,0,-0.388548712118999
"Nikles J.",1489.19569768977,1,1500,0,1500,0,1487.44126097088,1,1500,0,1488.63416575005,1,1489.23815156763,1,1500,0,0,0,0,1,0,-0.432172092409221
"Bellier A.",1489.07401421398,1,1500,0,1500,0,1489.04186926424,1,1500,0,1489.01096385567,1,1489.06932848034,1,1500,0,0,0,0,1,0,-0.437039431440861
"Santillan A.",1472.86280591259,2,1486.61724373009,1,1500,0,1484.88376132545,1,1500,0,1484.04264499423,1,1473.41758251323,2,1500,0,0,0,0,2,0,-1.0854877634963
"Serdarusic N.",1488.43342417434,1,1500,0,1500,0,1488.36380673233,1,1500,0,1487.52182795364,1,1487.13646419611,1,1500,0,0,0,0,1,0,-0.462663033026247
"Lopez-Perez E.",1493.8287121211,1,1500,0,1500,0,1492.61185433874,1,1500,0,1491.77684539545,1,1494.29825366549,1,1500,0,0,0,0,1,0,-0.246851515155982
"Smith A.",1489.06927831246,1,1489.01735960392,1,1500,0,1500,0,1500,0,1500,0,1489.2459243384,1,1500,0,0,0,0,1,0,-0.437228867501599
"Van Rijthoven T.",1491.8041560125,1,1486.64587689285,1,1500,0,1500,0,1500,0,1500,0,1490.66088493693,1,1500,0,0,0,0,1,0,-0.327833759500159
"Myneni S.",1492.21949308798,1,1487.54485424924,1,1500,0,1500,0,1500,0,1500,0,1500,0,1487.88192272857,1,1,0,-0.311220276480703,0,0,0
"Ivashka I.",1493.71242709752,1,1490.88504809359,1,1500,0,1500,0,1500,0,1500,0,1500,0,1487.22562860849,1,1,0,-0.251502916099041,0,0,0
"Maden Y.",1495.39672050617,1,1494.7876634704,1,1500,0,1500,0,1500,0,1500,0,1494.99762277134,1,1500,0,0,0,0,1,0,-0.18413117975323
"De Loore J.",1489.00124669909,1,1488.64435793348,1,1500,0,1500,0,1500,0,1500,0,1489.17974438616,1,1500,0,0,0,0,1,0,-0.439950132036431
