"Players","Ratings","games","Hard_Ratings","Hard_games","Grass_Ratings","Grass_games","Clay_Ratings","Clay_games","Carpet_Ratings","Carpet_games","NotHard_Ratings","NotHard_games","Bo3_Ratings","Bo3_games","Bo5_Ratings","Bo5_games","Bo5Played","Bo5Won","Bo5PlusScore","Bo3Played","Bo3Won","Bo3PlusScore"
"Dosedel S.",1421.65254706722,58,1458.48036789507,30,1504.8401574747,4,1439.99066466101,23,1487.5,1,1434.59568023817,28,1407.53558830664,42,1497.40637696772,16,16,8,1.28473069589495,42,14,-4.41862881320617
"Enqvist T.",1508.45713966878,249,1542.28620302863,159,1508.25928705593,22,1482.43699581693,47,1513.15138167223,21,1473.47893966853,90,1514.39925996195,197,1529.90324868704,52,52,29,-0.155159651450442,197,108,0.493445238201386
"Escude N.",1686.58065181597,185,1690.82279582848,104,1564.23699954426,28,1474.07813195154,28,1522.5322792169,25,1582.62467502949,81,1657.45880720269,148,1582.63174454893,37,37,22,1.14237501251764,148,86,6.32085106012095
"Federer R.",2102.86725950194,1223,2139.95798061969,737,1929.78899649866,165,1898.40571166659,262,1746.81928981421,59,1951.8281211485,486,2074.06239880997,841,1999.98328343915,382,382,325,11.8339380513082,841,683,12.2807523287694
"Fromberg R.",1413.80286064012,49,1487.81720629224,26,1499.95374611327,4,1412.98159827556,19,1500,0,1412.35231370585,23,1430.7505191723,39,1472.23523307682,10,10,4,-0.789657584705044,39,15,-2.65822798969007
"Gambill J.M.",1477.66781454555,271,1491.22050162191,197,1515.68023145602,33,1386.29153648889,30,1463.32198520294,11,1408.76072211569,74,1480.42016319805,229,1485.30378886715,42,42,19,-1.90159207744808,229,120,1.0083046592701
"Grosjean S.",1513.87102690905,455,1498.48870313995,258,1607.72018499243,62,1594.37567937548,99,1558.89614100666,36,1591.22047628273,197,1510.34878085928,347,1624.53406556773,108,108,72,7.30647787600984,347,197,-6.75163679964785
"Henman T.",1612.58399928022,423,1632.75794851689,249,1647.74457275246,60,1596.26492039583,77,1611.82118224002,37,1625.35355826124,174,1614.99889270258,326,1625.20086255014,97,97,67,2.99687700925031,326,210,1.50648296195844
"Hewitt L.",1600.18123476899,722,1617.91112681344,458,1689.09598011769,133,1610.26513600082,118,1569.78625293384,13,1639.07095113689,264,1622.26981322211,516,1638.1297521456,206,206,144,5.17949463926501,516,367,-1.17224524850559
"Lisnard J.",1459.20087119609,28,1447.46495235223,12,1500,0,1481.01764784361,16,1500,0,1485.8052310163,16,1457.09570966146,21,1475.3980376495,7,7,2,-0.188482321599214,21,7,-1.44348283055705
"Martin A.",1561.70339974973,414,1382.19972195738,137,1421.23364697986,18,1596.95660029724,253,1454.21611350591,6,1585.58996774323,277,1547.80418808754,360,1448.14465122178,54,54,20,-2.60940461329422,360,167,5.07754060328319
"Norman M.",1502.14259215583,182,1553.43181198077,106,1500.01671385569,2,1496.46240617735,73,1487.09831339114,1,1486.93308175798,76,1516.10052507646,153,1545.9822232385,29,29,19,0.775974233093776,153,88,-0.690270546860559
"Petrovic D.",1456.33625165601,8,1473.69739977226,4,1476.69705692732,4,1500,0,1500,0,1479.59392007398,4,1492.13295983411,5,1462.23357955609,3,3,0,-1.53096975843067,5,2,-0.215580175328988
"Sekulov J.",1435.20238485885,12,1456.2878039448,10,1486.63476371345,1,1486.64811173437,1,1500,0,1472.93143534685,2,1433.18390552577,10,1500,2,2,1,0.00349581895410611,10,2,-2.59540042460012
"Stoltenberg J.",1532.07469432337,49,1501.0251942206,32,1511.89564449752,7,1546.26053090058,10,1500,0,1556.24037403233,17,1544.23407602746,39,1481.72894874769,10,10,4,-1.17065619289104,39,24,2.45364396582607
"Vinck C.",1377.02948830962,36,1435.21065856816,16,1499.99648432736,8,1439.34047873717,10,1474.13742003437,2,1415.61128781268,20,1373.15844991439,29,1488.94240418887,7,7,3,-0.126590751745945,29,7,-4.79222971586934
"Agenor R.",1392.84415329499,26,1450.78502335265,11,1487.5,3,1435.52180833583,12,1500,0,1424.485766117,15,1407.3655049372,22,1476.29961122624,4,4,1,-0.83240513098137,22,6,-3.45382873721912
"Behrend T.",1404.04541839971,109,1401.73406026919,35,1454.38815476486,4,1465.49703017585,65,1512.90364114326,5,1444.91132293125,74,1418.63484882562,93,1400.87347696714,16,16,2,-3.4275934455945,93,37,-0.410589818417168
"Damm M.",1420.05525809393,42,1440.34077611796,21,1497.39008376095,12,1481.33585300854,8,1487.5,1,1465.44843137731,21,1449.15940032505,32,1439.11639624196,10,10,2,-1.68090967072367,32,14,-1.51688000551917
"Delgado J.",1398.81283902899,37,1429.83076277244,15,1428.94727401382,21,1490.72763614124,1,1500,0,1438.42894431745,22,1410.23597626399,26,1452.27583216388,11,11,2,-1.01098094422262,26,8,-3.03650549461771
"Golmard J.",1528.98901823162,142,1568.43857874004,86,1454.42540194182,12,1520.39540797287,38,1477.49820322675,6,1462.7821577525,56,1556.72252021638,120,1474.94085997822,22,22,9,-2.36324327826973,120,67,3.52280400753471
"Hantschk M.",1400.70213146032,58,1424.70072698506,24,1475.03176437078,4,1475.3784244352,30,1500,0,1462.62484440498,34,1416.51539140925,53,1466.09240323868,5,5,1,-1.14782265722317,53,22,-2.82409208436409
"Jonsson F.",1384.42443768212,22,1446.68114081783,13,1475.09264410069,2,1445.73501961563,7,1500,0,1420.52713102662,9,1405.46540774442,18,1473.7028709405,4,4,1,-0.936873291403442,18,4,-3.6861492013118
"Ketola T.",1451.86750114571,19,1468.44502774946,12,1475.37800025815,4,1500,0,1491.60737955047,3,1472.73627543718,7,1462.42948351987,15,1479.33802392642,4,4,1,-0.62008390247673,15,5,-1.30521605169469
"Manta L.",1421.99434766173,16,1481.0822383559,10,1462.08219715363,3,1464.97533958843,3,1500,0,1427.80362730433,6,1431.78489200857,15,1487.5,1,1,0,-0.517981188372765,15,4,-2.60224490515814
"Paes L.",1432.51861168502,14,1441.28319078828,11,1501.69471715219,2,1487.05047029068,1,1500,0,1485.80182743675,3,1429.15488971978,10,1499.07474857783,4,4,2,0.13179355862096,10,2,-2.83104909122031
"Pioline C.",1508.09517882332,116,1522.57474457801,54,1496.05318680763,15,1543.60600484602,41,1435.92902189165,6,1487.42654484466,62,1518.52778698976,95,1501.08328272921,21,21,11,-0.909002805565378,95,48,1.23280995849831
"Sanguinetti D.",1463.92895364698,281,1503.77388268888,154,1453.76056343945,40,1433.90573340219,62,1438.07261490594,25,1417.05466380806,127,1453.45908522779,241,1437.33987963426,40,40,12,-3.6947160422838,241,102,2.25187418816314
"Stanoytchev O.",1369.01062433697,28,1448.22854473991,9,1487.5,1,1417.35184336338,18,1500,0,1405.70681445918,19,1379.73389293871,24,1479.26530005594,4,4,1,-0.657193854844326,24,6,-4.5823811716769
"Tabara M.",1460.26311850676,79,1506.81760030311,40,1475.48415331792,2,1468.05538392323,32,1486.64132544484,5,1437.3065585819,39,1474.65941547002,62,1446.2861748015,17,17,5,-1.70482342984894,62,28,0.115348170119478
"Vanek J.",1445.81606249122,184,1408.73261251938,58,1445.51436399613,8,1491.97433496459,111,1422.77016195697,7,1453.12447854443,126,1445.42244727417,155,1376.27591011874,29,29,5,-3.93744649255704,155,61,1.77008899220598
"Vinciguerra A.",1503.86183459996,153,1494.82622637871,83,1465.69699579516,7,1499.15500593481,55,1530.99108102263,8,1503.46881976381,70,1495.89779951063,127,1490.93472499721,26,26,12,-0.435763995589932,127,61,0.590237379588177
"Bastl G.",1426.47090696941,114,1450.0531487758,74,1418.92719021599,15,1426.16731479622,12,1463.98105806566,13,1379.24150809894,40,1428.18977325273,101,1443.86015342263,13,13,3,-1.87009350551391,101,37,-1.0710702157097
"Berasategui A.",1402.5313219263,19,1451.22763354439,6,1488.33419129852,1,1440.80407711489,12,1500,0,1433.31949961214,13,1425.31812714848,16,1463.38290646128,3,3,0,-1.16974644371549,16,4,-2.72900067923263
"Caratti C.",1407.67753189506,13,1436.2183574939,7,1464.82035319984,5,1500,0,1487.5,1,1449.47429398356,6,1427.6806338351,11,1472.63454825927,2,2,0,-0.817286997250996,11,2,-2.87561172694679
"Cherkasov A.",1474.53687597421,4,1486.635633964,3,1500,0,1500,0,1487.5,1,1487.95675287176,1,1474.52072766726,4,1500,0,0,0,0,4,1,-1.01852496103177
"El Aynaoui Y.",1563.39582256342,274,1559.80787166964,125,1526.7055222149,16,1602.77561670639,117,1472.59934477843,16,1560.49674164259,149,1558.57233655457,223,1591.62803286459,51,51,31,2.41538491078132,223,125,0.120447991755367
"Gaudio G.",1500.64662963279,417,1520.38881536768,115,1471.33896068705,7,1539.64912599108,275,1469.19113969911,20,1517.85633302436,302,1505.65891430216,347,1575.3579099194,70,70,37,-3.79500599701715,347,207,3.82087118232875
"Kiefer N.",1657.35259746433,395,1696.73033016222,239,1562.88340979578,53,1587.54762044806,74,1554.43417105599,29,1623.09802875972,156,1651.09676735689,321,1613.46408502022,74,74,42,1.52335455059445,321,181,4.77074934797872
"Marin J.A.",1375.5368141635,81,1424.31661730723,9,1486.61761473855,1,1393.84033527151,71,1500,0,1382.83943793601,72,1390.99233874932,74,1425.85625146757,7,7,0,-2.58091761779081,74,26,-2.39760981566926
"Mirnyi M.",1534.12027582835,402,1512.33212441927,220,1583.61382337564,51,1460.69673019384,82,1521.9593202169,49,1538.93430714115,182,1519.00105814219,339,1528.7832928371,63,63,30,-2.24615547469129,339,171,3.61096650782522
"Santoro F.",1592.52794337372,433,1551.95263742863,252,1621.21061542112,67,1413.19606767568,66,1519.41761769838,48,1592.08184912666,181,1590.81915051009,354,1539.10657766562,79,79,38,0.648899809548793,354,184,3.05221792539985
"Schalken S.",1566.87539769352,299,1549.50188226987,170,1654.65275759079,48,1548.53701740764,60,1518.16278941378,21,1604.44372841802,129,1534.61845859858,241,1669.94850463658,58,58,39,6.98170276783126,241,129,-4.3066868600905
"Schuettler R.",1501.50841258312,543,1466.96678995556,313,1573.82644976268,71,1389.12361215214,129,1513.0174929231,30,1508.46017033454,230,1491.71522208171,454,1465.2429720719,89,89,43,0.883163605018423,454,226,-0.822827101693718
"Squillari F.",1553.6305017266,195,1506.17011834644,52,1451.71633544716,4,1541.13402260028,133,1454.43931200557,6,1528.84931616246,143,1556.12571914842,167,1488.01123232277,28,28,14,0.26563442392895,167,82,1.87958564513487
"Tillstrom M.",1495.98599244229,31,1511.45667438625,21,1474.55047029068,2,1507.01925243521,8,1500,0,1481.07119900592,10,1525.13386022284,26,1462.87220844559,5,5,1,-1.50941824263873,26,14,1.3488579403302
"Vacek D.",1388.48186285962,29,1420.84542558478,23,1482.89498086892,2,1452.46239729828,4,1500,0,1438.04811962268,6,1393.93034227783,24,1472.10739701483,5,5,1,-0.485951483007344,24,5,-3.97477400260769
"van Lottum J.",1400.85113139947,65,1406.90748885845,31,1462.19307395759,12,1461.67993357107,22,1500,0,1434.21338364438,34,1416.98284097184,50,1425.90877549935,15,15,3,-1.87202964745162,50,16,-2.09392509656942
"Balcells J.",1452.78185277687,78,1471.00775584022,35,1464.32167426039,3,1523.88057726771,39,1487.94952970932,1,1479.34520872848,43,1490.13266650381,67,1425.15277883906,11,11,2,-2.82539518500184,67,33,0.936669296076821
"Chang M.",1459.50277786692,141,1457.67944404808,95,1512.33475586707,17,1477.66533861751,25,1501.63271005524,4,1475.92803433211,46,1474.91271637402,119,1445.47036467025,22,22,8,-2.43753871279304,119,59,0.817649827470064
"Ferrero J.C.",1674.72021020111,682,1633.23425975728,301,1621.61577053399,47,1691.64292850645,307,1527.38963699561,27,1686.02677774931,381,1667.93665005511,529,1636.67996078067,153,153,103,3.66178379427576,529,337,3.32702461376863
"Gustafsson M.",1556.08193176772,68,1497.31927474973,18,1505.66774714701,12,1554.71066322527,31,1511.45775487763,7,1556.68981139569,50,1571.0440391655,59,1470.50527530781,9,9,3,-0.932966756637795,59,33,3.17624402734643
"Haas T.",1669.9573858324,661,1666.76847741741,417,1661.36995176339,66,1701.06842109355,148,1574.27834570915,30,1716.18629937941,244,1684.95309865325,524,1663.77765579435,137,137,89,2.68070443845697,524,334,4.11759099483892
"Johansson T.",1589.0845690424,374,1589.73817605718,229,1568.05602561946,55,1467.61590043248,54,1574.6505571008,36,1527.11130076438,145,1596.25190922998,300,1563.96607671517,74,74,45,5.42068916944836,300,158,-1.85730640775228
"Novak J.",1607.58639856857,358,1661.74918747893,175,1520.08532609071,27,1589.76517208469,124,1527.44194134444,32,1555.30584079435,183,1570.49001840828,291,1619.5860118301,67,67,42,2.62529582989023,291,170,1.67816011285233
"Rosset M.",1487.29616999234,137,1489.21767676647,54,1483.97609543228,18,1455.6452407988,39,1487.33154838281,26,1470.16482627106,83,1499.04870864798,116,1450.05837941471,21,21,8,-1.6333137321124,116,53,1.12516053180594
"Sell M.",1500.84942080171,2,1500.84942080171,2,1500,0,1500,0,1500,0,1500,0,1500.84942080171,2,1500,0,0,0,0,2,1,0.0339768320685254
"Arazi H.",1555.05134577196,220,1557.78597330988,105,1541.51724482312,23,1441.65341651867,66,1543.90086013111,26,1510.83501691177,115,1519.32603432286,171,1570.95086295368,49,49,28,4.46841824208841,171,83,-2.26636441121009
"Clavet F.",1454.49906415169,147,1509.77745847034,77,1490.68542363715,7,1412.82267527403,60,1464.39961716011,3,1385.15793945063,70,1468.72180886258,127,1442.31518911548,20,20,7,-1.79149189032819,127,57,-0.0285455436043996
"Clement A.",1538.65376523831,506,1516.52251509262,290,1526.42156020178,80,1472.07346199085,80,1496.37053831237,56,1499.60863304169,216,1528.15216014559,407,1506.01428914129,99,99,54,4.90514716984186,407,199,-3.35899656030934
"Corretja A.",1480.40384135652,239,1546.05775500944,108,1477.5646806819,2,1503.83975783356,118,1450.84736545913,11,1468.86231108379,131,1473.02848202852,194,1586.03155324029,45,45,30,4.53127649331687,194,108,-5.31512283905618
"Hrbaty D.",1498.05682585243,453,1521.68129963424,263,1443.36010844797,20,1497.99806049548,124,1545.73845586915,46,1489.34763051728,190,1519.78966058121,372,1515.16385223424,81,81,43,1.54217125726019,372,191,-1.61989822316296
"Ilie A.",1392.71158656029,104,1400.45550303195,56,1435.56371074905,6,1513.1026073063,39,1487.05047029068,3,1458.01241004965,48,1413.9760054903,86,1460.79141702548,18,18,7,-0.362493059140775,86,34,-3.92904347844771
"Koubek S.",1545.39751651034,359,1557.48477172701,190,1415.35564610304,26,1478.74611893291,122,1547.70056528603,21,1484.68891500923,169,1515.97286666258,297,1510.23387340999,62,62,28,0.134079290915847,297,132,1.68182136949772
"Kucera K.",1552.80770770371,172,1583.42978106594,98,1523.35932067077,26,1418.02629974939,35,1494.05560524809,13,1482.22393829511,74,1524.05134893373,138,1532.26536198225,34,34,16,0.593383174839734,138,70,1.51892513330855
"Lapentti N.",1503.52720009656,367,1500.57617915226,141,1482.9481169844,18,1525.68268324053,182,1469.49081265813,26,1489.40507462255,226,1540.53689888352,305,1466.69973215518,62,62,31,-1.66598600041882,305,149,1.80707400428111
"Ljubicic I.",1672.14637476297,646,1637.13165370627,372,1532.94991343896,50,1686.78547275428,155,1629.93058637406,69,1678.5147088326,274,1663.87300915357,547,1587.565038317,99,99,49,-12.6010461014454,547,337,19.4869010919641
"Martin T.",1582.45372374046,138,1578.58985503306,88,1565.58756701624,22,1481.03693254102,28,1500,0,1548.59853830733,50,1566.69868534776,91,1588.4064122444,47,47,28,4.13079192617835,91,48,-0.832642976559859
"Voinea A.",1435.57260092727,116,1486.74502122564,53,1469.90120149317,11,1438.10106249414,48,1478.81561128495,4,1416.8191873988,63,1428.13350442394,94,1481.97771050663,22,22,10,0.933500591624047,94,36,-3.51059655453315
"Agassi A.",1811.25861051798,350,1820.7034917839,256,1596.98061771682,29,1664.4188993096,58,1534.6156575585,7,1675.96761334161,94,1789.68861879507,237,1788.21304799219,113,113,91,10.4124996841529,237,175,2.03784473656622
"Alami K.",1378.96309897506,75,1397.35581182413,32,1488.75452877921,5,1453.65309855956,36,1475.44952970932,2,1432.01351662096,43,1373.16296880326,63,1480.63360785045,12,12,5,0.129827174789779,63,22,-4.97130321578724
"Bjorkman J.",1548.75653536885,359,1497.3038972317,211,1627.5739412886,76,1434.17144619322,43,1487.70931528978,29,1572.87824977949,148,1528.82827684447,285,1566.46035648267,74,74,41,6.09828739264091,285,136,-4.14802597788686
"Black W.",1483.83955398215,39,1459.73569944937,31,1479.59472656616,6,1500,0,1505.0619073996,2,1493.80606509221,8,1472.83787930481,30,1491.87597589937,9,9,4,0.281272260081697,30,11,-0.927690100795626
"Dupuis A.",1525.93437848902,193,1424.87001778143,84,1536.24030483014,39,1434.70615255946,57,1506.91842642179,13,1529.33037759893,109,1543.57566901454,165,1407.0003724885,28,28,8,-2.13002921244317,165,69,3.16740435200413
"Ferreira W.",1588.59358639871,211,1576.67821031725,134,1560.30897321715,29,1526.87459840637,37,1447.18731682436,11,1537.17609227684,77,1567.39248593228,158,1588.47895959054,53,53,33,4.59317449778661,158,84,-1.04943104183807
"Hill M.",1487.94433938657,3,1500.06196425891,2,1487.94952970932,1,1500,0,1500,0,1487.93337675196,1,1487.89934909509,1,1500,2,2,1,0.00247857035630217,1,0,-0.484704994893431
"Ivanisevic G.",1487.91247010746,108,1488.19319978167,72,1571.82888965054,19,1398.61012964885,10,1465.68647178851,7,1486.05325505228,36,1420.83233959536,88,1581.53750857584,20,20,13,4.71936705568189,88,33,-5.20286825138341
"Kafelnikov Y.",1610.35038680155,290,1614.36528297151,172,1581.7403730515,23,1595.64576052053,58,1620.29633432065,37,1621.61138301346,118,1610.72929854449,235,1593.27378511073,55,55,37,3.61377603264303,235,149,0.800239439418869
"Krajicek R.",1610.317073086,74,1541.41693919206,37,1553.16299469668,19,1534.38429771487,13,1512.2980779708,5,1584.19280971494,37,1582.38024922125,54,1567.92262779528,20,20,13,2.55250323427952,54,30,1.86017968916033
"Kroslak J.",1437.6130897267,18,1468.83463870651,13,1500,0,1475.82692918846,4,1487.5,1,1465.16945237682,5,1439.61086960646,16,1500,2,2,1,0.00257247591936571,16,5,-2.49804888685132
"Llodra M.",1625.06006233968,395,1607.89898761962,238,1607.88737538313,73,1493.63251177362,57,1451.98501905606,27,1597.03379357897,157,1642.41358316695,310,1503.06699126116,85,85,34,-3.52932329769553,310,148,8.53172579128265
"Philippoussis M.",1627.0624738078,220,1503.74827569663,138,1663.95119877877,45,1497.85318051938,26,1517.56285669844,11,1678.13264971749,82,1613.87034894325,163,1589.23684683533,57,57,35,5.39773361979062,163,91,-0.315234667478524
"Portas A.",1456.30025945346,220,1382.30328250117,32,1436.4941550296,12,1472.4098254114,171,1464.89420835247,5,1454.87202227616,188,1470.92852022846,188,1427.5044987182,32,32,12,-1.69703677017438,188,77,-0.05095285168716
"Pozzi G.",1398.64395043955,78,1441.12713465783,42,1512.00488200013,19,1436.52425876709,10,1488.95987475067,7,1443.04355427419,36,1417.73338647778,64,1475.49906526423,14,14,6,-1.01064928338522,64,27,-3.04359269903296
"Pretzsch A.",1443.24001175335,21,1460.77848190483,17,1470.42585525583,3,1486.42351207674,1,1500,0,1456.58587755732,4,1445.46267184501,18,1488.81777356997,3,3,1,-0.263426251377985,18,5,-2.00697327848815
"Rochus C.",1387.51386601986,320,1394.69325516299,128,1342.72911361483,25,1451.60965279482,150,1441.73255913801,17,1401.49696746904,192,1396.1685012552,271,1377.54513449511,49,49,15,-3.12358707742274,271,98,-1.37585828178265
"Sampras P.",1758.20963176989,137,1777.5313791612,98,1621.47046583404,24,1477.10734841255,15,1500,0,1569.90257442946,39,1653.96374643929,83,1733.80350648382,54,54,43,8.8345426447348,83,55,1.49384262606082
"Sluiter R.",1526.02639193338,197,1457.30135700496,80,1526.46152946434,45,1494.24109045187,63,1487.97467540654,9,1522.20742590134,117,1509.5941767029,160,1451.98824743551,37,37,12,-2.59691424405803,160,72,3.63796992139331
"Srichaphan P.",1573.01677319113,375,1570.83469845268,276,1545.49357535257,39,1349.52728406769,40,1558.26540470342,20,1507.31480426352,99,1590.27410527203,323,1501.07837843787,52,52,24,-2.8527098263124,323,180,5.77338075395739
"Stafford G.",1499.55219348043,2,1499.55219348043,2,1500,0,1500,0,1500,0,1500,0,1500,0,1500,2,2,1,-0.0179122607828529,0,0,0
"Tieleman L.",1446.06441673667,28,1494.50345137248,17,1465.09839119602,5,1455.72410694837,6,1500,0,1425.05963690615,11,1450.36277336447,25,1487.45935069303,3,3,1,-0.262266682117881,25,9,-1.8951566484152
"Ullyett K.",1462.07816215663,7,1461.45495234338,7,1500,0,1500,0,1500,0,1500,0,1462.49726102715,5,1500,2,2,1,0.0185807277373358,5,1,-1.53545424147218
"Vicente F.",1358.7247517599,248,1438.30526777408,83,1449.47453800804,15,1407.3968265314,142,1441.17846774213,8,1387.97275635692,165,1373.9018936211,206,1459.8534536717,42,42,18,1.02537954949101,206,82,-6.67638947909497
"Woodbridge T.",1466.56353731896,20,1443.14208754419,11,1512.76366205911,7,1499.55271256477,2,1500,0,1513.00134669422,9,1474.24417709297,13,1485.5566284931,7,7,3,-0.410593383340671,13,5,-0.926865123901001
"Woodforde M.",1462.99433420696,10,1468.21621345414,9,1487.5,1,1500,0,1500,0,1493.03931360787,1,1465.07128526565,7,1491.24787646698,3,3,1,-0.122891627806786,7,2,-1.35733500391465
"Woodruff C.",1458.24818595395,69,1491.35062194715,51,1481.51202653305,6,1430.19998339326,10,1499.99887807091,2,1434.11139870276,18,1436.46978065422,52,1516.25979596742,17,17,9,2.08045533348637,52,20,-3.75052789532835
"Zabaleta M.",1534.86512969246,297,1455.09604965717,102,1445.18944161515,5,1594.18061797969,185,1465.24539823863,5,1570.59910704945,195,1596.45596667092,255,1435.6409819585,42,42,17,-2.56724253535971,255,128,3.96184772305795
"Blanco G.",1431.02147587392,148,1397.25116247853,25,1452.97829485925,4,1472.65786176654,116,1465.02909305885,3,1444.83702974084,123,1412.58023721929,124,1487.7770123152,24,24,9,0.179743276834396,124,49,-2.93888424187774
"Costa A.",1552.17847371157,271,1512.48641385237,104,1486.59033155939,1,1575.57603112818,151,1469.97517875716,15,1561.71820309249,167,1556.63046106555,221,1580.99548885157,50,50,31,3.80374726200802,221,113,-1.71660831354531
"Mantilla F.",1556.07054095475,239,1508.98166937228,73,1463.01734052681,7,1600.55822091469,151,1450.94421859033,8,1563.98943231852,166,1562.35606633522,207,1469.91289558868,32,32,12,-4.24695304644702,207,111,6.48977468463713
"Pavel A.",1477.96654712605,361,1449.4405589802,166,1472.54035121595,35,1556.05101763741,130,1493.71158616603,30,1509.33100704281,195,1505.92837231732,301,1489.69124369137,60,60,29,-2.1557373081747,301,153,1.27439919321679
"Diaz J.",1368.40937943264,43,1392.62715903344,18,1487.93810396903,1,1433.36421155344,24,1500,0,1422.17679796963,25,1390.20748025168,33,1439.09589615944,10,10,2,-1.4481874886091,33,8,-3.81543733408534
"Guardiola T.",1452.85474395021,9,1503.74992284716,4,1500,0,1453.56483246912,4,1487.5,1,1441.11132777599,5,1463.2933121392,7,1478.3988148222,2,2,0,-0.454108913875407,7,2,-1.43170132811636
"Roux L.",1481.46570147867,13,1476.8011863168,13,1500,0,1500,0,1500,0,1500,0,1479.23419006434,13,1500,0,0,0,0,13,5,-0.741371940853147
"Siemerink J.",1421.45457336861,52,1461.7593757447,23,1459.87158128212,10,1462.79128206958,19,1500,0,1424.82050078729,29,1435.89940341183,43,1452.07657563226,9,9,2,-1.44386342296891,43,17,-1.69795364228674
"Courier J.",1490.9139660001,9,1491.2979876858,9,1500,0,1500,0,1500,0,1500,0,1500.52340321859,8,1487.5,1,1,0,-0.483309436881818,8,4,0.119868076885636
"Gimelstob J.",1436.17602741931,152,1424.26408429814,97,1512.67613881086,40,1423.17869094018,13,1479.25247700135,2,1457.42616228769,55,1430.04578537423,121,1448.26191060801,31,31,11,0.876102414181139,121,45,-3.42906131740864
"Goldstein P.",1517.24681831597,165,1527.31249657605,117,1493.49836764273,17,1484.20556893,26,1490.47654805697,5,1477.09770125083,48,1533.02989409192,143,1444.94149750598,22,22,7,-1.87377965100135,143,65,2.56365238364001
"Gumy H.",1437.4412309496,31,1469.36019695372,9,1487.96400122406,1,1456.00417938915,21,1500,0,1446.47367645723,22,1440.25551523176,25,1479.16558822975,6,6,2,-0.287089832344035,25,9,-2.21526092967207
"Larsson M.",1536.5863802164,57,1558.62730237036,35,1499.34093574909,12,1487.84909293593,10,1500,0,1485.01776427558,22,1541.49160860995,48,1499.08013608293,9,9,4,-0.269173936959058,48,27,1.73262914561522
"Liukko V.",1498.92974983855,4,1498.92974983855,4,1500,0,1500,0,1500,0,1500,0,1497.84869771671,4,1500,0,0,0,0,4,2,-0.0428100064579092
"Malisse X.",1566.05409350092,516,1523.02288287646,313,1662.49731069737,79,1461.18533744738,91,1541.94966090918,33,1606.71774235835,203,1566.6322830129,415,1537.7665838758,101,101,55,5.39315794996703,415,211,-2.75099420993022
"Mamiit C.",1393.90261505232,95,1414.71171526151,74,1437.46129366069,12,1449.4392439364,9,1500,0,1399.68382581428,21,1401.70510920815,81,1431.14196571597,14,14,3,-1.91034125393014,81,27,-2.33355414397703
"Sargsian S.",1502.86053407154,218,1495.19902342871,106,1437.30269774298,30,1495.03992297399,64,1527.84767823518,18,1492.38225319709,112,1487.05688771096,174,1524.5263826094,44,44,22,4.37018760792781,174,70,-4.25576624506641
"Zib T.",1421.17672881336,126,1399.4392339444,57,1470.47863051391,16,1419.67558774692,46,1455.34715966387,7,1423.7152294808,69,1407.15774148952,108,1436.19239621074,18,18,4,-0.608523104521263,108,33,-2.54440774294412
"Levy H.",1350.99062239051,119,1373.67127238054,68,1461.37772523438,16,1423.5534273728,30,1463.97272126128,5,1396.44762456485,51,1368.28548182156,102,1415.95121126169,17,17,4,-2.62134632494699,102,35,-3.33902877943261
"MacPhie B.",1502.45802055879,2,1502.45802055879,2,1500,0,1500,0,1500,0,1500,0,1502.23343674415,2,1500,0,0,0,0,2,1,0.0983208223517998
"Massu N.",1458.56561750246,431,1495.36685182094,153,1452.15071455499,17,1482.09774291924,244,1477.15098748037,17,1455.22011981445,278,1485.4305137516,371,1438.64063460432,60,60,23,-5.45284234624782,371,194,3.79546704634626
"Popp A.",1462.03647976665,108,1428.13622832511,41,1573.19996400154,38,1363.01829967509,27,1476.21298575131,2,1475.7613266309,67,1442.04507381764,75,1494.76986923217,33,33,16,2.9050680890447,75,28,-4.42360889837858
"Reneberg R.",1501.07533270558,2,1501.07533270558,2,1500,0,1500,0,1500,0,1500,0,1501.32739812423,2,1500,0,0,0,0,2,1,0.0430133082230404
"Rodriguez M.",1444.52543283319,15,1474.99803105724,4,1500,0,1465.87309147008,11,1500,0,1462.68404733342,11,1463.20945406344,13,1475.44952970932,2,2,0,-1.00581288471549,13,5,-1.2131698019571
"Sa A.",1399.49775063178,122,1431.98101219351,58,1475.25196387924,22,1378.55882750089,35,1493.13477389845,7,1405.67429706881,64,1394.74589562553,100,1467.3335815632,22,22,8,0.0903655368936189,100,36,-4.11045551162253
"Salzenstein J.",1423.17629246339,37,1426.09304840233,26,1483.11658381088,7,1486.40816618955,4,1500,0,1465.60468602568,11,1443.12777818312,33,1452.15117592252,4,4,0,-1.59081108327742,33,11,-1.48213721818698
"Black B.",1493.78777803362,74,1466.36052834073,48,1568.22360994058,19,1453.45183625691,6,1487.06662324804,1,1542.17230978442,26,1490.37793850432,59,1491.28144056993,15,15,7,-0.132850476799999,59,28,-0.115638401855214
"Dewulf F.",1476.79914190001,4,1489.22849795456,3,1500,0,1487.13077879029,1,1500,0,1487.13077879029,1,1476.44728737695,4,1500,0,0,0,0,4,1,-0.928034323999599
"Rusedski G.",1583.80300659498,274,1584.60027432912,161,1650.56129090377,58,1427.64350077188,26,1577.92430887422,29,1605.21475407162,113,1615.12724027165,229,1473.67810883032,45,45,21,-4.74478940231868,229,136,8.09690966611783
"Wessels P.",1521.18936870658,66,1439.23994484545,36,1567.17208421272,23,1474.69809479088,7,1500,0,1558.21997400511,30,1519.2192507334,55,1463.61063846904,11,11,3,-1.28068960547576,55,27,2.128264353739
"Saulnier C.",1514.16358579982,182,1509.45570783077,116,1456.19216318702,24,1430.13226689231,20,1529.09482069748,22,1479.28532518381,66,1512.70608614445,156,1411.40006563135,26,26,6,-2.45924101073533,156,67,3.02578444272831
"Tarango J.",1347.86271107016,44,1348.29915124465,22,1477.58193262568,4,1484.57543021503,17,1489.58795610896,1,1455.18934728291,22,1365.6152972323,38,1455.7870665851,6,6,1,-1.30671001354812,38,10,-4.77878154364559
"Canas G.",1542.39932882773,362,1624.34263643344,145,1574.70032368423,35,1616.01112510402,165,1467.39954562142,17,1563.49158530444,217,1554.9783645787,294,1557.94070881652,68,68,37,-1.46607072295091,294,181,3.16204387606024
"Chela J.I.",1518.41068718496,564,1496.5618232636,233,1431.2820609021,15,1586.52931020426,305,1435.34362780769,11,1565.98858713908,331,1514.90346459622,475,1540.74680523304,89,89,46,-2.54726464796033,475,256,3.28369213535884
"Hernandez A.",1456.36108177385,6,1500,0,1500,0,1462.08002315614,6,1500,0,1458.56884982126,6,1458.36806398157,6,1500,0,0,0,0,6,1,-1.7455567290461
"Kuerten G.",1495.73465352591,306,1571.72602165016,138,1513.46454842073,5,1572.36965249776,143,1549.90592660622,20,1559.12459054271,168,1503.61339571134,242,1606.501103498,64,64,43,-0.0509916012477608,242,162,-0.119622257715883
"Meligeni F.",1536.3070050132,124,1517.61134447128,42,1474.22995317832,4,1524.20145282953,75,1472.23939750009,3,1502.0863689636,82,1530.72142105631,105,1469.08232887777,19,19,7,-0.149521921807485,105,49,1.60180212233567
"Puerta M.",1587.4565795535,161,1473.88660289814,29,1461.75359245119,3,1649.15099362241,124,1464.00112958946,5,1589.329759657,132,1561.02105179572,137,1515.81739478748,24,24,12,0.645660167303706,137,72,2.85260301483648
"Heuberger I.",1421.55039568046,79,1425.44698637341,47,1465.21278679611,8,1426.62700799958,12,1480.46077595902,12,1423.79923196456,32,1418.89584809607,66,1446.68955068143,13,13,3,-0.891329068276518,66,22,-2.24665510450525
"Safin M.",1654.63762019294,540,1628.55993923655,295,1626.90695551888,42,1587.84890184714,141,1630.291159184,62,1615.96964540018,245,1638.26795191864,417,1692.40662058968,123,123,88,13.3950894435105,417,253,-7.20958463579267
"Bryan M.",1484.19931618455,13,1500.30065400151,9,1479.3019433043,4,1500,0,1500,0,1476.0034198309,4,1489.05919833061,12,1494.29229946826,1,1,0,-0.144807487202688,12,5,-0.487219865415333
"Calatrava A.",1403.05050577812,133,1429.30672847647,50,1465.82269961168,5,1433.34903739292,77,1487.5,1,1424.5323453052,83,1393.60388527338,115,1472.28447061682,18,18,7,0.125912085392852,115,47,-4.00389185426811
"Hipfl M.",1428.18566930883,90,1434.8557998572,17,1454.04130839282,6,1466.69115369466,67,1500,0,1438.14607631002,73,1446.74682791257,78,1420.60024767707,12,12,2,-3.55757529261575,78,34,0.685002064969157
"Rafter P.",1780.12360278692,103,1721.3505808602,65,1648.24147193818,26,1466.16882236783,5,1535.03949547424,7,1648.05702716411,38,1740.22202467966,75,1644.39621148908,28,28,21,3.46564747228132,75,51,7.73929663919551
"Alvarez E.",1431.76308110988,20,1449.95738272428,4,1500,0,1475.83960745286,16,1500,0,1472.8038920054,16,1439.07398040582,19,1489.18457842916,1,1,0,-0.265775396060822,19,7,-2.46370135954413
"Calleri A.",1517.46780448915,373,1519.39112483585,136,1447.72005485766,14,1573.02056438118,209,1475.99362855264,14,1530.89714144537,237,1540.38333520036,322,1422.6146839265,51,51,18,-7.98979731441005,322,177,8.68850949397591
"Garcia A.",1381.19281553861,34,1434.26270230464,11,1479.3114569937,2,1448.05983146845,21,1500,0,1423.68693145902,23,1386.8934502787,33,1486.66771631525,1,1,0,-0.504931407914176,33,9,-4.24735597054141
"Hood M.",1487.31042255386,5,1500,0,1500,0,1488.82661910907,5,1500,0,1487.18245743449,5,1487.56996255325,5,1500,0,0,0,0,5,2,-0.507583097845477
"Ulihrach B.",1458.12323786598,191,1536.9927779184,89,1447.12378914504,10,1442.2471102367,76,1473.46309982488,16,1410.24624769098,102,1456.05951389022,165,1426.69510531342,26,26,7,-3.77964305731937,165,79,2.10457257195856
"di Pasquale A.",1425.5673242305,85,1432.31313614929,26,1500,2,1428.2238301546,55,1474.56664341302,2,1420.94476939699,59,1409.1602955554,71,1476.93574349662,14,14,5,0.530443257863585,71,23,-3.50775028864347
"Etlis G.",1484.84952339908,30,1502.53686159712,7,1500,0,1457.31418014872,23,1500,0,1461.23645411948,23,1472.32654706634,28,1504.87793217113,2,2,1,0.470227849975641,28,10,-1.07624691401245
"Prieto S.",1450.73354258334,6,1500,0,1500,0,1458.81194986587,6,1500,0,1455.47686490973,6,1451.26365495936,6,1500,0,0,0,0,6,1,-1.97065829666653
"Moya C.",1587.31371848353,560,1606.62971870275,250,1496.18418715218,12,1620.47613599644,287,1523.27031576437,11,1612.65608027138,310,1615.7722502165,475,1576.59848155284,85,85,51,-5.3540354158147,475,312,8.84658415515592
"Rios M.",1710.35005743709,161,1728.09498602507,102,1500,0,1602.22284165469,56,1462.93621530287,3,1569.59435634383,59,1724.96336876637,141,1526.06922758191,20,20,11,-0.11407628236381,141,89,8.52807857984723
"Arthurs W.",1553.18031053387,240,1527.93109493265,142,1515.27672680585,49,1445.70919939172,44,1488.8774590916,5,1494.26874076782,98,1546.58960548388,191,1459.08791232616,49,49,20,-0.151148602870758,191,84,2.2783610242254
"Fish M.",1739.69209826032,496,1704.88624265966,358,1685.98236348108,72,1532.02448834441,52,1483.12489587655,14,1681.54697165968,138,1719.37154529121,406,1690.07821070108,90,90,52,-1.13337240166357,406,237,10.7210563320763
"Kratochvil M.",1466.84483845362,159,1491.53696013094,82,1512.10226478932,21,1480.94364909514,45,1440.64294368336,11,1465.46355653875,77,1462.45999282523,136,1485.6970135716,23,23,10,-0.293094388279985,136,60,-1.03311207357523
"Medvedev A.",1497.3414598746,61,1470.19560059969,18,1475.9970540356,4,1528.23632006494,37,1499.56774126876,2,1502.69231859205,43,1514.27598318588,51,1477.03395081526,10,10,4,-1.10082059684087,51,25,0.994478991824801
"Roddick A.",1830.43743850196,769,1794.58987468812,536,1781.71882749373,102,1625.77375054487,95,1617.78075305831,36,1777.93334287048,233,1820.84556658447,592,1761.2565811238,177,177,132,1.14628667144321,592,442,12.0712108686351
"Alonso J.",1457.35187948085,13,1450.02165411732,4,1500,0,1494.56608486708,9,1500,0,1493.29231352881,9,1468.42599846263,12,1487.5,1,1,0,-0.517288700387528,12,4,-1.1886361203786
"Huet S.",1395.61646482827,27,1428.77781289774,9,1490.93661414021,5,1460.75481283887,10,1463.83133671542,3,1437.34864700865,18,1397.20929905199,20,1469.67951208301,7,7,2,-0.556574986362021,20,4,-3.61876642050711
"Bruguera S.",1463.74678874956,72,1455.2076455944,10,1486.61928929314,1,1509.28162133269,59,1499.53712018102,2,1492.39585807505,62,1492.4846861735,66,1451.45508586139,6,6,1,-2.38261330889048,66,32,0.932484858872797
"Coutelot N.",1486.13213726071,32,1483.86789020398,2,1475.26401998934,2,1505.61847724755,28,1500,0,1485.48357446145,30,1454.61680285213,22,1517.06076797134,10,10,5,1.43785552815547,22,8,-1.99257003772705
"Lopez-Moron A.",1413.8669942683,10,1475,2,1500,0,1435.60435189135,8,1500,0,1435.31211785025,8,1425.36861662883,9,1487.5,1,1,0,-0.5,9,1,-2.94532022926782
"Willems R.",1500.90466303186,2,1500,0,1500,0,1500,2,1500,0,1500,2,1500.55231072213,2,1500,0,0,0,0,2,1,0.0361865212744723
"Wiltschnig H.",1473.10274826107,4,1500,0,1500,0,1475.60027306286,4,1500,0,1474.89446688486,4,1472.74738210104,4,1500,0,0,0,0,4,1,-1.07589006955731
"Boutter J.",1494.53153758985,138,1448.39267168278,54,1421.84913090261,9,1538.16395667919,55,1503.22096384018,20,1505.78080879636,84,1545.74541650196,117,1405.63464694712,21,21,4,-4.64096426291183,117,56,4.42222576650574
"Ruud C.",1453.27001935946,31,1467.86943659641,6,1475.46338095484,2,1484.26511449524,22,1487.5,1,1462.12126907135,25,1483.50926336904,27,1453.17927000896,4,4,0,-1.77288425780933,27,11,-0.0963149678124374
"Navarro S.",1499.40725607772,5,1500,0,1500,0,1496.73607462047,5,1500,0,1498.03102323109,5,1496.98049725932,5,1500,0,0,0,0,5,2,-0.0237097568912542
"Coria G.",1529.15412685233,321,1638.20174514977,114,1540.19991179466,16,1601.72431974574,182,1529.97747188992,9,1566.41062460466,207,1538.0291792719,253,1642.06598928523,68,68,44,-0.605638519749312,253,166,1.77180359384274
"Browne F.",1458.77652551153,28,1478.48120013871,6,1500,0,1466.09907058469,22,1500,0,1462.91319095651,22,1451.41870743974,24,1499.48387099292,4,4,2,0.375375889662939,24,9,-2.02431486920172
"Delgado R.",1472.87652333488,83,1471.19290207288,61,1460.00256132686,6,1492.12634655112,16,1500,0,1456.97325264319,22,1469.85633654204,68,1482.33968433593,15,15,6,1.00527400470966,68,26,-2.09021307131449
"Gonzalez F.",1686.8363542349,514,1683.38217689277,245,1600.3018782279,35,1752.70067564275,207,1552.97328107399,27,1731.11205667233,269,1689.89818517828,395,1699.15647233702,119,119,75,1.69394686709761,395,250,5.77950730229827
"Russell M.",1503.86682425886,224,1525.75723842047,143,1431.62313955692,33,1386.03301773869,47,1487.97862312439,1,1394.35390951962,81,1552.18773099829,184,1358.55386170167,40,40,7,-4.77536878386134,184,70,4.93004175421583
"Sabau R.",1394.76317294151,44,1456.75809928159,7,1463.45311161096,5,1431.83790148929,30,1474.0085112085,2,1405.10134408846,37,1412.15619920528,40,1462.31785923556,4,4,0,-0.933742191749254,40,13,-3.27573089059052
"Kohlmann M.",1469.16146211571,43,1429.35431147882,16,1470.90211158614,9,1515.37647053195,16,1499.47021836798,2,1505.29312912358,27,1470.24735941146,40,1471.02887728416,3,3,0,-0.765929759304731,40,15,-0.467611756066812
"Gaudenzi A.",1436.91142367405,107,1379.89522293312,37,1475.44842793373,2,1496.2802057753,60,1461.21193116267,8,1476.57030330849,70,1442.30165530685,91,1448.14922219767,16,16,5,-1.83624666374903,91,34,-0.687296389289193
"Charpentier M.",1442.25070115486,8,1500,0,1500,0,1448.25755164347,7,1492.05262887145,1,1440.5522189802,8,1437.11988729711,6,1499.79140148266,2,2,1,0.244358264927972,6,0,-2.55433021873359
"Eschauer W.",1384.89861867331,52,1410.60535863287,12,1490.64827968096,3,1447.81320861742,36,1486.57129121434,1,1442.18560884802,40,1386.7648625223,42,1469.1898145065,10,10,3,-0.451459194712763,42,12,-4.15259605835497
"Savolt A.",1442.13890931228,73,1416.86369188747,23,1473.23621322603,2,1488.95678688933,47,1487.43550226181,1,1469.85086372803,50,1434.63358336071,60,1475.1461004636,13,13,5,-0.226739440600541,60,23,-2.08770418690815
"Burrieza O.",1469.56038552406,5,1500,0,1487.05047029068,3,1476.53957173515,2,1500,0,1465.40073197485,5,1467.78023470985,5,1500,0,0,0,0,5,1,-1.21758457903765
"Prinosil D.",1433.84982766992,77,1409.29109786144,38,1531.77888293976,21,1422.39852801877,7,1530.17987304497,11,1503.94813417615,39,1430.24143397271,62,1494.55395536532,15,15,7,-0.151610048277567,62,24,-2.49439684492561
"Bryan B.",1446.83158216613,40,1445.00906682435,21,1518.89567005005,14,1459.81541201295,4,1487.06668960131,1,1471.75373069683,19,1444.62920504733,36,1480.75290851847,4,4,1,-0.243283200853533,36,12,-1.88345351250131
"Knippschild J.",1430.09437552714,42,1428.53736482077,10,1518.38278796059,10,1447.984140916,22,1500,0,1457.08819255039,32,1422.16942501806,33,1477.23804556355,9,9,3,-0.125425819291384,33,11,-2.6707991596229
"Nestor D.",1440.71555002357,26,1447.58278106624,15,1478.80212385948,10,1500,0,1487.5,1,1472.94715590276,11,1411.18504382898,17,1517.09733385903,9,9,5,1.36579855395106,17,3,-3.7371765530082
"Parmar A.",1458.76772020097,37,1466.83334873739,11,1456.82768897743,25,1500,0,1487.17366431058,1,1456.48588814997,26,1476.06024790993,29,1463.04204605441,8,8,2,-1.2895562978681,29,11,-0.359734894093236
"Wheaton D.",1483.37208288301,4,1476.81992904684,2,1499.55047029068,2,1500,0,1500,0,1501.77623486336,2,1482.91839130946,4,1500,0,0,0,0,4,1,-0.665116684679472
"Cowan B.",1448.74881733714,16,1463.89063229949,7,1472.08201007153,9,1500,0,1500,0,1473.40296682425,9,1455.39926159019,10,1483.14568102515,6,6,2,-0.376672129516476,10,3,-1.673375176998
"Braasch K.",1516.90110419895,3,1500,0,1514.12251002442,3,1500,0,1500,0,1516.94147344351,3,1517.80189846726,3,1500,0,0,0,0,3,2,0.676044167958072
"Youzhny M.",1606.37808645572,808,1613.3952757873,414,1620.63748760205,97,1511.36205766124,236,1580.2925538191,61,1545.36333127569,394,1581.35849676666,649,1633.09053916608,159,159,99,8.72396751743251,649,354,-4.46884405920372
"Bower J.",1495.76490531583,3,1500,0,1487.19300534187,3,1500,0,1500,0,1493.22850527302,3,1500,0,1489.25259424598,3,3,1,-0.169403787366949,0,0,0
"Godwin N.",1430.91247759758,28,1400.84671122656,13,1506.16266110388,15,1500,0,1500,0,1518.7520843814,15,1431.69580972138,23,1494.29540760306,5,5,2,-0.0252372640396226,23,8,-2.73826363205726
"Lareau S.",1444.88876066737,26,1460.69626764664,19,1488.86716952564,5,1474.13046844236,2,1500,0,1465.92021879094,7,1456.47814375101,22,1477.95562030269,4,4,1,-0.783409311939252,22,8,-1.42104026136589
"Lee M.",1415.10939950349,46,1421.84884094178,16,1482.80585242359,25,1465.71954970954,5,1500,0,1456.96570411948,30,1430.55044239115,35,1455.1883388246,11,11,3,-0.913032402358874,35,12,-2.48259161750163
"O'Brien A.",1448.83715329512,11,1450.80092695072,8,1501.14695515403,2,1500,0,1487.05047029068,1,1489.34094145808,3,1465.31426358983,7,1475.54415415539,4,4,1,-0.832793049215813,7,2,-1.21372081897957
"Rochus O.",1527.41726960951,472,1554.20478634688,230,1545.19106124093,80,1425.83637607704,138,1508.13714333312,24,1494.13581279488,242,1551.85894944695,389,1435.95178151502,83,83,35,-3.92017690590637,389,185,5.01686769028693
"Spadea V.",1447.75576592184,368,1459.34645913617,235,1501.790407597,46,1476.35126314504,65,1474.29291582331,22,1475.60027377656,133,1451.57197706523,316,1461.86496718679,52,52,20,-0.625113663461023,316,148,-1.46465569966536
"Voltchkov V.",1472.74543526365,103,1500.03501379371,65,1488.64655621221,17,1432.38083552225,10,1490.61235520168,11,1435.55242273734,38,1478.4297750025,84,1480.05952516864,19,19,8,0.74155465703372,84,37,-1.83173724648776
"Draper S.",1504.3978828511,54,1518.00893223419,35,1459.94344435097,14,1454.80891578844,5,1500,0,1441.8902145167,19,1526.96475572168,37,1419.61218820138,17,17,3,-2.12674414762959,37,16,2.3026594616734
"Davydenko N.",1596.53662709276,779,1653.24898493604,404,1451.39969567909,28,1551.56915771903,291,1681.17002228054,56,1543.54650513813,375,1598.65040232081,646,1623.27566014039,133,133,83,1.78510171770803,646,381,2.07636336600217
"Kempes E.",1430.69015522164,24,1465.51539649215,13,1463.8142032083,3,1493.96679168277,8,1500,0,1457.798638345,11,1465.33938761818,21,1463.57844057293,3,3,0,-1.46002069806336,21,9,-1.31237309307094
"Roitman S.",1394.35942435061,87,1399.37540793118,17,1460.13825234506,6,1448.10305282293,62,1474.16976813425,2,1421.67012832932,70,1421.65152714883,75,1409.10491971292,12,12,0,-2.43691176051797,75,25,-1.78871126545759
"van Scheppingen D.",1445.55923370475,47,1465.86707786772,20,1459.30739308623,10,1467.24103256121,17,1500,0,1443.10210625878,27,1461.84910438623,43,1460.06637441491,4,4,0,-1.42740489760256,43,16,-0.750225754207435
"Elsner D.",1390.45513492904,31,1456.10918322016,6,1487.5,1,1429.2959313561,24,1500,0,1416.70684015514,25,1408.12819556679,25,1463.72084869802,6,6,1,-1.0857446435604,25,7,-3.29604995927814
"Goellner M.K.",1452.94703509118,25,1504.36026899753,6,1475,2,1454.47053236602,17,1500,0,1439.3201915166,19,1457.105154475,24,1486.90252653804,1,1,0,-0.357561206954613,24,9,-1.52455738939825
"Carretero R.",1497.30138755993,4,1500,0,1500,0,1498.74333997102,4,1500,0,1497.75224221373,4,1499.38794282761,4,1500,0,0,0,0,4,2,-0.107944497602903
"Martelli M.",1490.55042498278,5,1502.36625032467,2,1500,0,1488.68187583629,3,1500,0,1487.89384986485,3,1489.52087567006,5,1500,0,0,0,0,5,2,-0.377983000688864
"Puentes G.",1425.62741440868,22,1473.50585179913,5,1498.86993451853,2,1439.67818860236,15,1500,0,1437.83226675665,17,1430.96190685306,18,1481.66927032972,4,4,1,-0.418591484756612,18,5,-2.55631193889609
"Sanchez D.",1496.43511185651,200,1376.9496803471,44,1451.12200324835,4,1543.37718402404,149,1466.30939952574,3,1520.6220397559,156,1486.62486456906,173,1445.1607402436,27,27,8,-2.65457431853234,173,77,2.51197879279262
"Schranz W.",1495.50460458306,2,1500,0,1500,0,1497.55857313612,2,1500,0,1497.25718962506,2,1496.25059058673,2,1500,0,0,0,0,2,1,-0.179815816677523
"Luzzi F.",1455.44467265543,44,1466.96652113429,11,1500,0,1477.3687634332,31,1474.41653974177,2,1454.42202690074,33,1475.10899450913,38,1462.20138084148,6,6,1,-1.44677513432227,38,15,-0.335437959460412
"Mathieu P.H.",1569.9184022648,548,1504.12907599478,242,1501.75699978028,52,1589.87854965822,206,1542.58878230327,48,1590.25903686148,306,1572.58142314647,455,1522.7406092002,93,93,45,2.65918477545032,455,224,0.137551315141572
"Motomura G.",1424.16113936825,20,1425.86133645588,17,1487.63643602396,3,1500,0,1500,0,1489.90687841981,3,1434.87371886073,18,1477.28130255229,2,2,0,-0.70537419015657,18,5,-2.32818023511335
"Furlan R.",1458.15106363565,18,1479.17388532439,11,1500,0,1470.45266870016,7,1500,0,1471.16093981851,7,1450.04999139813,16,1501.58984412111,2,2,1,0.229523968424598,16,5,-1.90348142299845
"Nargiso D.",1550.55720747875,11,1501.1638107866,2,1500,0,1556.91895841036,9,1500,0,1555.9522197125,9,1552.41173213968,11,1500,0,0,0,0,11,8,2.02228829915012
"Stoliarov A.",1427.96139766132,87,1448.36409731999,42,1461.88311815985,17,1452.07757007465,23,1464.66413504982,5,1419.46604498464,45,1417.85044850697,75,1488.50929856017,12,12,5,0.779476648892387,75,27,-3.66102074243955
"Larose S.",1519.43586358496,12,1505.79605928409,12,1500,0,1500,0,1500,0,1500,0,1518.33280851629,12,1500,0,0,0,0,12,5,0.777434543398509
"Dent T.",1586.11551214738,280,1585.81603162491,203,1540.08238076847,51,1446.33114305443,16,1525.91035022758,10,1522.01032828337,77,1553.41891855679,228,1568.68294308188,52,52,27,2.44831005986356,228,119,0.996310426031784
"Capalik K.",1469.98085926993,8,1483.93001241513,3,1501.07455327042,4,1487.94452789918,1,1500,0,1489.75503686931,5,1470.26260701884,8,1500,0,0,0,0,8,3,-1.20076562920264
"Kim K.",1426.21787199674,137,1428.7432796149,101,1423.41657018512,17,1445.42794559945,15,1478.44871413691,4,1395.9723061989,36,1415.64911991051,116,1434.36204898864,21,21,6,-0.641227440843972,116,38,-2.31005767928656
"Taino E.",1467.23773481787,26,1472.8778847425,22,1500,0,1478.5858240172,4,1500,0,1478.1933550515,4,1478.99846749722,24,1475.31307905549,2,2,0,-0.86723998705528,24,10,-0.44325062023008
"Kralert P.",1477.33877815118,4,1500.19782632622,2,1500,0,1475.77593609507,2,1500,0,1474.71947266391,2,1473.59242867638,2,1500.3296011959,2,2,1,0.142218435825742,2,0,-1.04866730977851
"Lee H.T.",1557.31784007541,265,1558.7997619893,181,1505.52339427094,36,1509.27870016949,46,1475.44952970932,2,1531.64887787022,84,1553.04718774122,214,1509.95998724205,51,51,22,1.45388806235236,214,96,0.838825540663947
"Pescariu D.",1490.5527706032,3,1500,0,1500,0,1491.9735992812,3,1500,0,1491.25117717237,3,1491.48502672416,3,1500,0,0,0,0,3,1,-0.377889175871813
"Erlich J.",1489.82745982734,9,1504.92009847706,6,1486.01841882072,3,1500,0,1500,0,1484.58487369086,3,1490.56009927531,9,1500,0,0,0,0,9,4,-0.406901606906497
"Tarallo S.",1497.34881358258,2,1500,0,1500,0,1498.39713943389,2,1500,0,1498.04828254527,2,1497.92192895308,2,1500,0,0,0,0,2,1,-0.10604745669698
"Flygt K.",1499.75883182046,4,1513.29846883224,3,1500,0,1488.88822930684,1,1500,0,1489.17968334171,1,1498.63094878918,4,1500,0,0,0,0,4,2,-0.00964672718167203
"Friedl L.",1484.77713759818,8,1472.15133251053,4,1500,0,1515.34065857746,3,1488.5524274831,1,1505.91276918197,4,1485.00190943026,8,1500,0,0,0,0,8,3,-0.60891449607271
"Suzuki T.",1554.05301692363,37,1552.35431296409,34,1489.09726226904,3,1500,0,1500,0,1485.23619198033,3,1554.46400710135,31,1484.95799031977,6,6,2,-0.572666636101233,31,16,2.73478731304625
"Yoon Y.",1490.42085238165,7,1497.44390046751,6,1489.14061342703,1,1500,0,1500,0,1491.08656964013,1,1495.95644590563,6,1491.80336369198,1,1,0,-0.286558899514715,6,3,-0.0966070052193009
"Viloca J.A.",1504.24237537714,12,1506.13287616209,6,1500,0,1502.13057943772,6,1500,0,1501.12503110495,6,1505.24226379962,12,1500,0,0,0,0,12,6,0.169695015085508
"Thomann N.",1477.01335051033,37,1513.72812137879,18,1488.49185415075,3,1444.01888709541,7,1486.44839383655,9,1441.04054489869,19,1480.04108056413,33,1481.58440041203,4,4,1,-0.471741752466694,33,13,-0.447724227120091
"Burgsmuller L.",1391.70214308823,178,1424.13988663015,101,1448.73670883106,23,1406.09620307238,47,1462.70588193397,7,1381.32785011885,77,1376.18063349473,146,1445.74580908793,32,32,11,0.011721376811775,146,52,-4.34363565328258
"Bachelot J.F",1490.39910174388,8,1508.18210248048,2,1478.54089568452,2,1499.78700130664,2,1501.69814581689,2,1478.95553572416,6,1486.11692685507,5,1493.50351652261,3,3,1,0.162487501246191,5,2,-0.546523431490933
"Palmer J.",1510.72137891448,4,1517.84404858848,3,1487.5,1,1500,0,1500,0,1487.83314886987,1,1509.64385974477,4,1500,0,0,0,0,4,2,0.428855156579285
"Childs L.",1443.6405862471,10,1498.83729298357,2,1436.37904978334,8,1500,0,1500,0,1441.58340255114,8,1465.27951587083,5,1467.6581499462,5,5,1,-0.859160503110853,5,1,-1.39521604700498
"Froberg J.",1507.24086871113,2,1505.5642924567,2,1500,0,1500,0,1500,0,1500,0,1506.1566429235,2,1500,0,0,0,0,2,1,0.289634748445352
"Ortegren J.",1500.97314754356,2,1502.20597498572,2,1500,0,1500,0,1500,0,1500,0,1501.07746330445,2,1500,0,0,0,0,2,1,0.0389259017424473
"Phau B.",1522.67254223743,211,1494.89555073378,137,1395.92684901184,14,1485.80714601057,57,1464.45750511215,3,1450.74356276079,74,1525.897324593,179,1401.66190947806,32,32,7,-3.03763885356434,179,70,3.94454054306154
"Pless K.",1406.82194393133,121,1422.37709087287,71,1424.39499640188,16,1438.74604375633,25,1499.12418911274,9,1407.07379198719,50,1403.97264698167,94,1441.72367512424,27,27,9,0.608666440396573,94,33,-4.3357886831434
"Robredo T.",1670.18910432234,839,1654.91750673859,387,1542.92122491526,54,1671.55956892128,364,1511.37685621404,34,1656.96733658435,452,1669.16571558971,673,1683.94740469585,166,166,108,6.64616255058426,673,404,0.161401622309254
"Weiner G.",1436.19871322935,30,1432.86636208961,25,1490.56849111197,5,1500,0,1500,0,1487.99931233475,5,1439.42921165715,26,1475.47814745613,4,4,1,-0.40078946155904,26,9,-2.15126200926693
"Armando H.",1447.78210522982,43,1502.80827052949,5,1500,0,1423.7348136858,38,1500,0,1424.97985588592,38,1455.5295322732,41,1477.96250836903,2,2,0,-0.785956591336402,41,13,-1.30275919947063
"Hadad M.",1498.20845600365,4,1500,0,1500,0,1499.34518111631,4,1500,0,1498.16197642203,4,1499.47760586005,4,1500,0,0,0,0,4,2,-0.0716617598541039
"Hirigoyen I.",1480.14043088604,4,1488.65424741998,1,1500,0,1485.63676786699,3,1500,0,1485.54328324758,3,1478.01618420087,4,1500,0,0,0,0,4,1,-0.794382764558259
"Nalbandian D.",1751.00405631436,537,1745.13515385225,262,1640.3585093789,42,1723.10354519246,189,1728.41441230132,44,1748.88683566294,275,1759.92914637904,409,1663.25357406642,128,128,88,3.06640161766627,409,269,6.97376063490805
"Simoni A.",1417.0052749834,30,1448.5370604126,15,1465.02136662538,5,1490.55648995554,10,1500,0,1450.33698671177,15,1426.47965521763,26,1474.52828280203,4,4,1,-0.741213418806606,26,9,-2.57857558185741
"Tobon M.",1498.16804677279,2,1500,0,1500,0,1500.06674213707,2,1500,0,1500.02841153771,2,1498.48792005081,2,1500,0,0,0,0,2,1,-0.0732781290883612
"Mahut N.",1668.26832239054,349,1549.45286159635,186,1708.51336923312,98,1460.80987253388,47,1419.1605218709,18,1690.44253138052,163,1623.45479742396,279,1539.61214080143,70,70,26,-2.92984918683349,279,130,9.66058208245517
"Lopez F.",1707.58592035843,783,1691.98802126349,438,1658.21862054461,96,1627.5324074738,219,1510.05616422495,30,1657.49368769979,345,1674.84294793176,634,1684.87619062469,149,149,88,8.46574162804164,634,325,-0.162304813704529
"Acasuso J.",1598.64995462311,359,1522.37877427833,106,1406.23450245494,8,1636.95151789384,233,1455.60991975577,12,1610.25885598333,253,1593.80016405991,313,1427.85867062257,46,46,14,-6.57120454107285,313,167,10.5172027259973
"Tursunov D.",1566.00191145708,424,1583.91754088789,267,1553.09021272154,63,1503.33501410556,71,1476.92415447129,23,1532.4530717832,157,1592.97964343879,343,1466.51115361833,81,81,38,-1.86995510370115,343,181,4.51003156198454
"Saretta F.",1505.39014723036,142,1484.88840061991,40,1500.4445191567,12,1541.1936807279,89,1489.67308881876,1,1518.05764959729,102,1518.3711251624,113,1470.80545735888,29,29,12,-0.370089216280224,113,55,0.585695105494525
"Montanes A.",1560.99473270593,538,1415.26938877915,118,1454.4160104523,19,1586.09648796768,396,1449.15222484271,5,1568.58652970364,420,1596.55026228986,455,1426.25618507769,83,83,30,-8.51670492440729,455,223,10.9564942326446
"Gross O.",1448.8109312521,12,1487.92866525186,1,1487.41403230829,1,1464.41146216869,10,1500,0,1453.24509811933,11,1448.06758555392,12,1500,0,0,0,0,12,3,-2.04756274991585
"Blake J.",1576.90556939683,566,1594.69575070216,409,1523.22556275976,56,1549.64023078597,79,1520.56478344143,22,1533.60300467865,157,1587.84455372826,463,1562.64552509853,103,103,60,-1.66609064011292,463,279,4.74231341598624
"Santopadre V.",1481.35007393067,4,1500,0,1500,0,1491.73120008826,3,1487.63483077351,1,1479.66370190162,4,1479.85086739168,4,1500,0,0,0,0,4,1,-0.745997042773172
"Traykov I.",1499.44561622705,2,1500,0,1500,0,1499.25618958016,2,1500,0,1498.09376852972,2,1499.9080120244,2,1500,0,0,0,0,2,1,-0.0221753509180675
"Andersen J.F.",1474.3591607762,8,1487.95689990999,1,1500,0,1479.86660652713,7,1500,0,1479.48563378122,7,1467.33166380558,6,1502.5575359856,2,2,1,0.258343212534883,6,1,-1.28397678148699
"Ondruska M.",1445.77200983015,8,1445.50741162142,5,1487.5,1,1507.7927620527,2,1500,0,1494.30569463457,3,1438.63195662452,5,1488.21777391325,3,3,1,0.177391879672105,5,0,-2.34651148646592
"Elseneer G.",1428.0254124488,38,1439.52469623801,10,1479.51964041581,20,1491.41532137286,5,1488.09136455003,3,1460.52779102831,28,1429.62802156404,28,1478.33004784062,10,10,4,-0.149723733415726,28,10,-2.72925976863218
"Allegro Y.",1453.16035868051,13,1472.1956524639,2,1472.3667876306,10,1492.3838084616,1,1500,0,1469.44233053551,11,1451.63675062869,13,1500,0,0,0,0,13,4,-1.87358565277973
"Carlsen K.",1512.24615788577,189,1522.84255060477,126,1479.31279681028,32,1396.1661614678,18,1499.41799910079,13,1451.76056498984,63,1521.97292854161,165,1393.34078266884,24,24,5,-4.68579911389284,165,77,5.17564542932378
"Settergren J.",1483.22038753543,6,1475.0270380815,2,1500,0,1504.31482399519,4,1500,0,1501.87272708172,4,1483.06451151277,6,1500,0,0,0,0,6,2,-0.671184498582941
"Mutis O.",1462.77642359474,60,1430.52191769814,15,1487.44708412932,5,1516.41142912391,39,1487.09564005016,1,1505.00970820117,45,1455.84664921685,48,1490.06434767798,12,12,5,0.72789561719051,48,19,-2.21683867340103
"Lopez M.",1473.21468480559,52,1497.72197089525,3,1493.30646161167,3,1477.31173578995,46,1500,0,1463.70034472448,49,1488.94895221819,47,1468.63707146987,5,5,1,-1.36261847210789,47,20,0.291205864331324
"Wassen R.",1466.79518173389,8,1499.66122424192,2,1488.39731929921,1,1474.28586966236,5,1500,0,1460.97495455829,6,1467.44581480364,8,1500,0,0,0,0,8,2,-1.32819273064449
"Horna L.",1509.28470072738,249,1455.60009000294,81,1432.78371088188,6,1572.74913405526,159,1463.34826553989,3,1541.23135386496,168,1543.72607149082,215,1388.30467430777,34,34,9,-6.05648488704124,215,104,6.42787291613647
"Serrano O.",1482.17862101041,8,1500,0,1500,0,1485.15762018709,8,1500,0,1481.95115285492,8,1492.14456276828,7,1487.05047029068,1,1,0,-0.520968590786762,7,3,-0.191886568796995
"Kutsenko V.",1465.26280272876,10,1461.99545198723,8,1500,0,1502.29395585946,2,1500,0,1500.48126620257,2,1467.98678537109,7,1487.27467604415,3,3,1,-0.0691557478899466,7,2,-1.32033214295973
"Marach O.",1448.55205233653,45,1467.74292356193,11,1486.96731614586,1,1475.42463653845,30,1486.47408465093,3,1460.4845546057,34,1473.03267697088,40,1442.10535880969,5,5,0,-2.20521310486653,40,16,0.147295198327696
"Peya A.",1403.52980836959,63,1454.27142649438,21,1418.85560884644,15,1431.51638558649,22,1519.29703961595,5,1397.42259653187,42,1419.03279350556,52,1456.62004716255,11,11,3,-0.971484033345135,52,15,-2.88732363187143
"Trifu G.",1458.0011635139,8,1500,0,1475.88649878002,2,1481.98609728881,6,1500,0,1456.95719578554,8,1457.82628757425,8,1500,0,0,0,0,8,2,-1.67995345944395
"Vacek J.",1446.96066560133,88,1365.35525179699,44,1518.74785285903,29,1447.65430152932,15,1500,0,1506.68465785454,44,1454.13631158951,73,1445.67183430249,15,15,4,-1.40653537801401,73,26,-0.715037997932632
"Ginepri R.",1542.62745558784,378,1504.5550934081,266,1479.92016521174,50,1514.16409202883,42,1492.63028007913,20,1542.63712893283,112,1535.60458504876,311,1512.74582130211,67,67,31,0.443688857720092,311,153,1.2614093657936
"Cuadrado C.",1510.66219139064,8,1500,0,1500,0,1510.70340853554,8,1500,0,1510.3722745158,8,1512.10538055418,8,1500,0,0,0,0,8,4,0.426487655625587
"Labadze I.",1494.21863676763,117,1443.95355927454,49,1480.73212503994,14,1458.7327949944,50,1476.00764737761,4,1487.52857751523,68,1441.18405366473,97,1478.44133978145,20,20,7,0.872838563386207,97,33,-1.10409309268086
"Behr N.",1494.82155953551,9,1495.70355872808,9,1500,0,1500,0,1500,0,1500,0,1494.51950689455,9,1500,0,0,0,0,9,4,-0.207137618579767
"Okun N.",1419.67802401188,62,1427.27760739616,47,1441.8056962402,7,1502.24564956896,4,1481.86437360389,4,1437.06815397398,15,1422.46824099588,53,1452.29178763163,9,9,2,-1.47329749601246,53,18,-1.73958154351246
"Joyce M.",1501.53234745128,6,1501.6415613532,6,1500,0,1500,0,1500,0,1500,0,1501.91732592532,6,1500,0,0,0,0,6,2,0.0612938980513404
"Kim A.",1409.32040312974,32,1424.42800762658,25,1488.27064638523,3,1455.84597240351,4,1500,0,1452.35759306249,7,1423.21147701021,24,1465.49945995481,8,8,2,-0.68862626644629,24,6,-2.93855760836423
"Brasington J.",1449.34142992925,10,1460.39706552697,6,1486.37537632024,1,1488.34238735941,3,1500,0,1473.11668142969,4,1484.36521190346,2,1450.94509520442,8,8,2,-1.52432022705357,2,0,-0.502022575776349
"Ramirez Hidalgo R.",1486.06781026437,16,1500,0,1500,0,1481.71668493843,16,1500,0,1478.25971753827,16,1485.86065002069,16,1500,0,0,0,0,16,6,-0.557287589425172
"Mello R.",1446.64897040153,137,1441.35135353855,77,1432.42530829728,9,1476.26522074674,49,1474.31805202064,2,1442.05008993985,60,1441.30676726721,113,1433.72740314044,24,24,7,-0.351380930899153,113,44,-1.78266025303959
"Ogorodov O.",1477.97123714362,12,1474.22315537396,9,1500,0,1500.1080871655,3,1500,0,1498.99429908584,3,1469.86673575953,10,1499.34928640066,2,2,1,0.193411670585891,10,3,-1.07456218484099
"Tebbutt M.",1486.92202501043,3,1487.75162174246,3,1500,0,1500,0,1500,0,1500,0,1486.29764739138,3,1500,0,0,0,0,3,1,-0.523118999582741
"Terachi T.",1464.76921446069,11,1468.27313712506,11,1500,0,1500,0,1500,0,1500,0,1463.12577945881,11,1500,0,0,0,0,11,4,-1.40923142157231
"Fukarek O.",1397.95121975453,14,1418.2674794086,9,1488.19191033066,3,1476.19943129508,2,1500,0,1465.01144570582,5,1415.69217463798,12,1474.93904760831,2,2,0,-0.93868380067989,12,2,-3.14326740913893
"Kondo H.",1476.58309962268,4,1473.03822064101,4,1500,0,1500,0,1500,0,1500,0,1475.93545029058,4,1500,0,0,0,0,4,1,-0.936676015092797
"Udomchoke D.",1349.66856638158,69,1356.39256712527,49,1446.57227859241,16,1464.33805304397,4,1500,0,1426.40608935755,20,1343.48462164623,55,1465.68110371406,14,14,4,0.548911517138349,55,13,-6.5621688618752
"Benneteau J.",1619.13217080383,514,1595.19039709721,318,1522.72768039864,64,1511.86935290396,104,1548.61497473865,28,1530.34951443658,196,1639.06038090233,423,1538.41247821052,91,91,42,-0.787277286106857,423,206,5.55256411826
"Melzer J.",1609.14884422978,623,1573.98448408561,320,1581.31629578527,70,1578.77205322071,220,1459.63897614231,13,1593.80248405623,303,1594.79085589749,513,1595.3555212074,110,110,59,2.91275913555182,513,264,1.45319463363924
"Zimonjic N.",1462.68823964155,16,1465.60691461373,3,1506.23586161223,4,1474.44134709143,5,1478.37762197678,4,1471.32446654662,13,1467.77546765461,15,1486.30393074448,1,1,0,-0.522218351819136,15,4,-0.970252062519002
"Nieminen J.",1542.23396516374,690,1537.94513673421,422,1481.9963464005,55,1539.33498328283,183,1527.62122566875,30,1529.62255886066,268,1521.01878048521,582,1559.3770941911,108,108,54,2.25048368868673,582,303,-0.561125082137194
"Soderling R.",1974.27925216964,449,1910.74289627108,257,1639.99316860497,43,1842.77366019095,120,1633.96637496396,29,1887.45492290455,192,1949.29550841666,368,1769.19070733896,81,81,51,3.21298530568727,368,234,15.7581847810984
"Galvani S.",1433.37405174591,51,1445.97842192824,16,1486.31118046938,7,1434.33253919104,26,1501.31770438642,2,1452.27423030102,35,1436.29951957254,37,1449.21702472181,14,14,4,-0.841502483391605,37,12,-1.82353544677212
"Karlovic I.",1778.52762570913,593,1717.76093146354,355,1698.82119092184,100,1574.69212757631,114,1498.39642717105,24,1687.38823603797,238,1748.0004055663,500,1580.31597127652,93,93,44,-1.37078520012301,500,274,12.5118902284883
"Knowle J.",1397.53843738168,39,1422.71707223907,16,1462.57350995502,12,1429.37580084565,11,1500,0,1420.01663938716,23,1393.70372363811,30,1472.17171077546,9,9,3,0.115751587624817,30,6,-4.21421409235767
"Stepanek R.",1667.93835100645,627,1608.52727325366,356,1625.74454866078,71,1609.55965297363,163,1576.35092941137,37,1658.40468331436,271,1691.48660516554,514,1525.3360136865,113,113,57,-7.17485513629286,514,298,13.8923891765508
"Nielsen M.",1439.03359886112,9,1435.01724755658,9,1500,0,1500,0,1500,0,1500,0,1438.09137941319,9,1500,0,0,0,0,9,1,-2.4386560455554
"Carraz G.",1471.45043642681,82,1489.87565014024,52,1484.2992341443,15,1469.35459083009,4,1489.81142747828,11,1469.8254542875,30,1461.15022807386,70,1494.05155051926,12,12,5,0.649083391674715,70,29,-1.79106593460217
"Gicquel M.",1480.0317511709,205,1534.98789329466,99,1466.50455882331,26,1488.36313178984,59,1520.65583692026,21,1441.51549847744,106,1516.99790155651,166,1466.90339142008,39,39,15,-0.17312692484785,166,77,-0.625603028315988
"Silva J.",1440.69226547496,11,1473.80186940137,2,1500,0,1448.02500625353,9,1500,0,1451.26100063227,9,1458.1342909948,9,1473.12704274905,2,2,0,-0.829373701166952,9,2,-1.54293567983466
"Morrison J.",1459.33281537241,85,1462.22967137591,65,1467.35379109946,16,1483.21416415258,4,1500,0,1454.35279227151,20,1484.58578204166,73,1442.87351190737,12,12,3,-1.54378276896425,73,29,-0.0829046161394987
"El Aarej M.",1447.03835536394,7,1500,0,1500,0,1447.81859925108,7,1500,0,1448.10391912348,7,1447.53081893684,7,1500,0,0,0,0,7,1,-2.11846578544256
"Gasquet R.",1822.40538170239,693,1772.00994237972,411,1685.06830926845,80,1810.50079468169,184,1578.24940810092,18,1818.86363612293,282,1782.36532336479,549,1807.63650394295,144,144,96,5.41143096526411,549,346,7.48478430283169
"Krajan Z.",1399.29986085281,33,1451.18220608497,8,1487.14744174243,1,1426.13563115781,24,1500,0,1419.11593583652,25,1410.39082926113,30,1465.56843685633,3,3,0,-0.799776412616664,30,8,-3.22822915327093
"Perez D.",1447.53955366359,7,1500,0,1500,0,1443.57977797846,7,1500,0,1444.96388384396,7,1458.06544355381,6,1487.09378297823,1,1,0,-0.518371872207163,6,1,-1.58004598124922
"Nadal-Parera R.",1497.87346422265,2,1500,0,1500,0,1500.8683590741,2,1500,0,1500.65099381632,2,1497.37475363161,2,1500,0,0,0,0,2,1,-0.0850614310938939
"Galimberti G.",1413.14047410277,21,1453.62610290169,6,1500,0,1469.01149773497,12,1461.50733076843,3,1437.24000403685,15,1418.11914017096,15,1475.79696372728,6,6,2,-0.471422247910928,15,3,-3.00295878797837
"de Chaunac S.",1436.47421036223,22,1446.83597668544,16,1500,0,1481.85766885121,4,1475.02283220471,2,1465.33212098584,6,1437.12696947887,18,1482.16052554196,4,4,1,-0.475301736295274,18,4,-2.06572984921539
"Hadad A.",1500.9341017775,6,1503.90923461661,4,1500,0,1501.12298920912,2,1500,0,1500.18961984978,2,1500.22753296254,4,1499.28398244317,2,2,1,0.0138092834267721,4,2,0.0235547876732305
"Ancic M.",1749.41330344028,313,1727.09628561573,168,1710.82736149015,50,1639.05147712916,55,1595.99137726066,40,1718.25102642185,145,1706.55417863845,250,1720.90731949655,63,63,43,9.40713953581819,250,149,0.569392601792661
"Beck K.",1411.61322433304,170,1426.05684657457,102,1468.31390911826,31,1365.39822494266,22,1537.8875200203,15,1444.38373263076,68,1418.35733012967,133,1455.50774828356,37,37,13,0.72209924605976,133,47,-4.2575702727382
"Waske A.",1442.72346826442,89,1412.28617177812,29,1439.35174561566,15,1461.0419614422,41,1480.39434067015,4,1450.0614361111,60,1457.53248180593,76,1416.66486296286,13,13,2,-2.61065584486198,76,25,0.319594575438954
"Fraile G.",1433.31545693508,9,1492.58506531759,1,1500,0,1439.68272176423,8,1500,0,1435.18527241012,8,1433.29649251856,9,1500,0,0,0,0,9,1,-2.66738172259689
"Blake T.",1471.48984082698,8,1483.04176177315,5,1499.91429368542,2,1487.5,1,1500,0,1486.44026065232,3,1470.70174811794,8,1500,0,0,0,0,8,3,-1.14040636692079
"Vahaly B.",1399.52639656952,64,1417.58055727162,47,1463.70103149237,10,1448.21628925943,7,1500,0,1426.8756637555,17,1404.342878247,56,1461.31050489242,8,8,1,-1.13428381605264,56,20,-2.88466032116666
"Verkerk M.",1495.67044943889,117,1456.62227480378,42,1470.92893054915,9,1541.02858994635,54,1557.29142678532,12,1519.11040636925,75,1489.05899241762,98,1530.65907021133,19,19,10,1.49907503254717,98,44,-1.67225705499158
"Ferrer D.",1796.03479841558,976,1800.37851436841,482,1637.36108136877,59,1864.59113852714,414,1490.29841273605,21,1797.74105294238,494,1767.51834841754,780,1830.8748381021,196,196,141,3.37261418503678,780,511,8.46877775158674
"Hanescu V.",1566.13965657569,411,1463.60898982409,138,1463.22073836474,32,1618.84466882803,227,1467.35015515732,14,1591.3863635535,273,1562.35637196583,341,1501.50796436268,70,70,31,2.01158424985816,341,155,0.634002013169545
"Radic M.",1483.71347846985,6,1500,0,1500,0,1478.96344622352,6,1500,0,1479.22823035805,6,1483.44309257748,6,1500,0,0,0,0,6,2,-0.651460861205999
"Schiessling T.",1484.41819520025,4,1500,0,1500,0,1486.90443934075,4,1500,0,1484.7763589397,4,1484.63448648693,4,1500,0,0,0,0,4,1,-0.623272191990043
"Bogomolov Jr.A.",1484.53688081053,4,1480.84334322678,4,1500,0,1500,0,1500,0,1500,0,1509.58492273786,2,1475.13307617941,2,2,0,-1.05180351147019,2,1,0.433278743891521
"Verdasco F.",1664.26138675945,772,1599.12705970453,368,1605.26045893185,74,1683.57042063204,308,1531.75460650722,22,1685.09200403488,404,1642.72039159161,623,1669.80885533584,149,149,94,8.48434021566702,623,351,-1.91388474528909
"Dancevic F.",1482.49781070774,139,1431.16330007926,89,1506.05829748757,42,1453.47004454462,4,1481.31947837903,4,1487.74856563824,50,1510.2908788777,115,1407.67326669962,24,24,5,-3.80289645562986,115,47,3.10280888393962
"Norman D.",1426.84201862193,54,1441.23948818756,16,1474.10399190291,19,1418.61511541767,16,1487.0002698351,3,1433.81953627375,38,1421.2782522812,40,1449.94012495061,14,14,4,-0.129463994529399,40,10,-2.79685526059324
"Giner J.",1491.47212344648,5,1500,0,1500,0,1495.53195187242,5,1500,0,1492.63269888111,5,1491.50862716873,5,1500,0,0,0,0,5,2,-0.341115062140682
"Washington M.",1464.96625796435,5,1466.22507326402,5,1500,0,1500,0,1500,0,1500,0,1465.17165428785,5,1500,0,0,0,0,5,1,-1.4013496814261
"Johansson J.",1672.68123568158,119,1683.42073367539,88,1517.72107305863,12,1418.34946643593,13,1524.86549833256,6,1476.01185328829,31,1651.50843751803,95,1592.11316096653,24,24,15,4.29217108870991,95,52,2.61507833855328
"Vliegen K.",1473.27352375219,196,1464.1111833608,84,1452.98751554503,27,1503.95288448643,72,1489.49570707715,13,1481.99517690286,112,1511.21160970146,164,1396.48099927934,32,32,9,-5.06756424415404,164,74,3.99850519424182
"Lisnard J.R.",1433.21894004001,89,1455.78128232361,46,1468.32163590239,5,1424.95732138695,36,1500.10540597206,2,1420.46095678484,43,1432.7942504485,69,1466.55417298649,20,20,7,0.287832079323636,69,24,-2.95907447772325
"Van Lottum J.",1500.10462232383,3,1498.11337442831,3,1500,0,1500,0,1500,0,1500,0,1500.12123312413,3,1500,0,0,0,0,3,1,0.00418489295304247
"Hantschek M.",1503.3569197285,2,1503.42662251424,2,1500,0,1500,0,1500,0,1500,0,1502.77293519502,2,1500,0,0,0,0,2,1,0.134276789139924
"Luczak P.",1439.31698441485,114,1446.78882431306,53,1515.72414523852,8,1401.86704400394,53,1500,0,1426.63057720745,61,1441.2204216959,91,1431.09059949254,23,23,6,-0.559009226438005,91,29,-1.86831139696791
"Crabb J.",1444.78082817752,8,1441.79583704863,8,1500,0,1500,0,1500,0,1500,0,1446.76033836009,5,1490.66538605965,3,3,1,-0.11824820615123,5,0,-2.09051866674783
"Larkham T.",1476.81119286348,7,1500.25980183757,4,1489.11088974371,1,1478.3084428073,2,1500,0,1470.79890956199,3,1492.90075876607,1,1472.75395146244,6,6,1,-0.678316875381861,1,0,-0.249235410078942
"Sirianni J.",1485.26342919881,20,1492.15811594416,15,1464.7093607482,5,1500,0,1500,0,1469.22457835204,5,1491.33245444032,16,1480.72051973813,4,4,1,-0.542066351006651,16,6,-0.0473964810409795
"Varlet J.",1475.63370058451,11,1456.54936609856,4,1500,0,1482.06636767031,4,1514.45722371128,3,1503.03772837712,7,1476.04810990065,7,1479.84400905029,4,4,1,-0.285965386400811,7,2,-0.688686590218837
"Cadart R.",1472.68997445085,7,1505.89495821209,4,1485.57420210951,1,1486.79775724438,1,1488.6239307308,1,1464.41750139867,3,1481.58453474054,6,1487.5,1,1,0,-0.499953510214668,6,2,-0.592447511751395
"Gambill J. M.",1497.83035320512,4,1495.82962773465,4,1500,0,1500,0,1500,0,1500,0,1497.13288545884,4,1500,0,0,0,0,4,2,-0.0867858717950433
"Fleishman Z.",1456.61732388108,24,1446.1311206218,21,1489.60446001238,3,1500,0,1500,0,1490.31378576141,3,1456.18774956035,20,1476.29129018934,4,4,1,-0.273816973426744,20,6,-1.46149007133015
"Daniel M.",1381.43387404487,83,1352.50505642622,22,1453.84710630248,7,1462.29585743617,54,1500,0,1443.36513722213,61,1411.51063201861,66,1382.42623512474,17,17,1,-3.5446465983897,66,19,-1.19799843981562
"Gamonal H.",1470.02645327261,7,1485.27379139368,1,1500,0,1483.06582208347,6,1500,0,1480.31918361808,6,1482.2779263316,6,1486.54131284969,1,1,0,-0.558030362783582,6,2,-0.640911506312174
"Massa E.",1467.79427950628,24,1493.37464244244,5,1487.0274228142,1,1471.79877974597,18,1500,0,1460.63865156326,19,1479.19983614744,22,1476.66193527249,2,2,0,-0.85735344877864,22,8,-0.430875370970194
"Melo D.",1475.65606153516,5,1484.51722534577,1,1500,0,1487.65845588033,4,1500,0,1486.24676168401,4,1476.20531300852,5,1500,0,0,0,0,5,1,-0.973757538593572
"Marin J.A",1507.15924593547,2,1500,0,1500,0,1504.78188403365,2,1500,0,1502.44429990046,2,1506.96213145043,2,1500,0,0,0,0,2,1,0.286369837418683
"Miranda I.",1466.58561962515,19,1458.92221390561,9,1510.16310149021,3,1492.63363469527,7,1500,0,1498.96623222698,10,1483.63929664364,16,1470.35626397313,3,3,0,-0.95531628597268,16,7,-0.381258929021499
"Abel M.",1464.18556441938,9,1473.85642117951,5,1491.03469087827,1,1490.34472570365,3,1500,0,1481.42828141865,4,1470.47523495482,8,1484.73478182651,1,1,0,-0.434526323066225,8,2,-0.998051100158629
"Kendrick R.",1437.97038489885,112,1471.56203805905,82,1423.06499419789,18,1433.1727749698,12,1500,0,1389.16225781358,30,1437.91765007459,91,1427.71788135097,21,21,4,-1.31344279132222,91,31,-1.16774181272376
"Di Pasquale A.",1471.1273748656,5,1464.54488769263,5,1500,0,1500,0,1500,0,1500,0,1481.65613230161,4,1487.6545885182,1,1,0,-0.514993515876841,4,1,-0.639911489498972
"Lapentti G.",1416.72709666636,29,1466.4467699699,17,1484.94721989676,3,1432.24988518374,9,1500,0,1421.55709975245,12,1431.09745431465,26,1467.94989763702,3,3,0,-0.979028012662286,26,7,-2.35188812068348
"Prodon E.",1361.92163788486,20,1467.66645158551,3,1500,0,1373.7348670907,17,1500,0,1378.18523065698,17,1397.49482211621,13,1440.93706701614,7,7,0,-1.69783343764165,13,1,-3.82530104696383
"Mota B.",1493.04400341772,3,1500,0,1500,0,1487.25770113251,3,1500,0,1489.83152715148,3,1491.80412647987,3,1500,0,0,0,0,3,1,-0.278239863291163
"Volandri F.",1359.07740104642,381,1272.73291570881,63,1415.57534795573,13,1409.46882246179,290,1414.9641498029,15,1398.95436865571,318,1378.12374351943,337,1345.64326771385,44,44,9,-9.86757463026043,337,158,4.23067067211726
"Nadal R.",1993.54923341667,943,1900.20064147231,474,1736.90282593034,75,2106.45424192685,380,1526.83420338991,14,2057.65463282922,469,1988.72215994547,700,1989.70467687891,243,243,211,13.5958557237963,700,562,6.14611361287028
"Srichaphan N.",1502.09986768919,4,1500,0,1500,0,1502.1627701472,2,1502.36622805821,2,1500.86154128592,4,1501.61912998658,4,1500,0,0,0,0,4,2,0.0839947075677197
"Cermak F.",1471.76848368016,24,1462.82863920156,3,1502.57793004165,2,1506.34856965852,19,1500,0,1503.15586274751,21,1468.64054470984,24,1500,0,0,0,0,24,9,-1.12926065279376
"Schuettler P.",1513.91604721729,3,1500,0,1500,0,1514.49975089567,3,1500,0,1514.79248804315,3,1512.85899358639,3,1500,0,0,0,0,3,2,0.556641888691487
"Kohlschreiber P.",1734.97220623615,641,1654.96705410261,325,1672.81986012025,81,1740.83104024444,217,1533.59599488971,18,1759.66819932438,316,1752.33815629924,532,1617.62237437945,109,109,60,1.41375078434853,532,299,7.98513746509743
"de Voest R.",1514.97052849526,29,1501.50186465761,22,1494.9526353209,5,1500,0,1496.05198538112,2,1498.57299517732,7,1516.83687678324,26,1493.12305127259,3,3,1,-0.227612650933126,26,11,0.826433790743568
"Bogdanovic A.",1417.68476582351,37,1471.72598526923,5,1402.11090425871,32,1500,0,1500,0,1404.96436492364,32,1454.19825010037,28,1422.67564030411,9,9,0,-2.75571293201494,28,10,-0.536896435044632
"Reid T.",1511.30630780751,35,1497.46578170357,26,1484.41054061916,8,1487.01679372319,1,1500,0,1469.9569959198,9,1522.35081401475,27,1464.38836252444,8,8,2,-0.998573438017116,27,12,1.4508257503175
"Baccanello P.",1465.91304274275,9,1462.34508732077,7,1499.21945762656,2,1500,0,1500,0,1497.9115312319,2,1472.57237079969,6,1489.26294132998,3,3,1,-0.288056233083314,6,1,-1.07542205720681
"Niemeyer F.",1466.50629704808,20,1444.02170266892,17,1489.16908791275,3,1500,0,1500,0,1497.00081799681,3,1455.31830881378,18,1500.33795708702,2,2,1,0.344248202294595,18,3,-1.68399632037129
"Moodie W.",1564.1049117351,110,1545.92363668872,77,1496.32477551111,21,1464.75893588629,5,1497.96851883145,7,1491.13343851651,33,1544.38187333602,95,1502.23299040926,15,15,6,1.09343724329849,95,41,1.47075922610535
"Rehnquist B.",1459.9338777479,13,1439.1291374197,7,1500,0,1507.70950382813,6,1500,0,1507.49414000601,6,1474.54929575723,10,1473.46338408962,3,3,0,-0.888756443912088,10,3,-0.713888446171999
"Vemic D.",1492.36552927555,21,1477.67187668254,5,1501.58824769221,6,1509.85444044314,10,1500,0,1500.99345762513,16,1501.79527435705,20,1486.11944875359,1,1,0,-0.557906779260336,20,9,0.252527950282434
"Guccione C.",1494.75080451166,89,1529.80796916309,64,1437.07998030062,16,1458.56880431919,8,1492.79888135141,1,1412.08992461697,25,1509.379792304,72,1416.38463647764,17,17,4,-3.07215782700037,72,30,2.86219000746661
"Hernandez O.",1427.06752888095,189,1343.01207533111,33,1419.77813278713,10,1497.29605946025,143,1487.14114706153,3,1472.84566768844,156,1462.04221918024,159,1368.26401781582,30,30,6,-4.4233671139301,159,59,1.50606826916802
"Wawrinka S.",1917.5012644858,649,1880.01027114573,352,1610.60127689618,48,1899.00920492818,229,1499.92768081687,20,1871.77281517036,297,1821.52767013779,486,1951.59982290836,163,163,118,15.0011733202057,486,296,1.69887725922628
"Ram R.",1504.81918516959,145,1460.04479222103,101,1539.25179079692,34,1464.45013670425,10,1500,0,1509.39737827768,44,1508.5945015171,124,1430.95307540363,21,21,5,-2.40043316437266,124,49,2.59320057115638
"Delic A.",1491.26285870204,76,1506.89240591791,60,1472.15773583468,8,1459.20568356576,7,1487.5,1,1424.96732381031,16,1449.83988466818,59,1508.39187156325,17,17,7,2.21212302387982,59,18,-2.56160867579821
"Amritraj P.",1473.84851054024,35,1398.92541435632,22,1539.41281804835,13,1500,0,1500,0,1537.74670233577,13,1475.26890273542,34,1486.44894022199,1,1,0,-0.303956836019138,34,13,-0.742102742371286
"Bogomolov Jr. A.",1479.31663208967,9,1471.74273127158,9,1500,0,1500,0,1500,0,1500,0,1493.75881316161,7,1476.15140837026,2,2,0,-0.793328228446823,7,3,-0.0340064879663291
"Tipsarevic J.",1606.7431861988,447,1622.98152867389,267,1564.22859002829,60,1576.19622015956,98,1513.41273120405,22,1585.02301753156,180,1598.27769289612,353,1633.71616693472,94,94,50,4.72913390143639,353,183,-0.459406453484357
"Mergea F.",1502.6352355302,4,1500,0,1500.04196309118,2,1500.63020755964,2,1500,0,1500.74488182525,4,1500.83273132814,4,1500,0,0,0,0,4,2,0.105409421207928
"Tuksar S.",1455.39539424814,7,1485.81793568378,1,1500,0,1466.68935046227,6,1500,0,1465.15025902863,6,1467.51397338133,5,1479.12614329094,2,2,0,-0.456004108992715,5,1,-1.32818012108188
"Youzhny A.",1519.94519432916,5,1508.94538573383,5,1500,0,1500,0,1500,0,1500,0,1517.73073547392,5,1500,0,0,0,0,5,2,0.79780777316628
"Berdych T.",1889.71572451228,810,1845.44376704966,516,1718.92609272409,82,1840.29828234764,191,1575.03716541433,21,1852.2243919458,294,1829.86191435697,627,1873.39026380956,183,183,131,12.9774454965048,627,400,2.61118348398637
"Andreev I.",1534.09652240749,431,1526.38835738883,171,1498.2770217184,33,1542.48184890502,199,1527.66163874917,28,1525.85492287493,260,1558.21201289567,362,1534.88992907277,69,69,36,2.6262259421656,362,182,-1.26236504586597
"Moldovan I.",1455.88733453722,6,1500,0,1500,0,1458.43104365767,6,1500,0,1456.42571538279,6,1455.16808466474,6,1500,0,0,0,0,6,1,-1.76450661851112
"Ascione T.",1384.04121166487,73,1419.55935980215,32,1458.48161403429,4,1429.39339236936,29,1472.05424833635,8,1404.38027001343,41,1418.74006614786,58,1397.89416623107,15,15,2,-3.29616079613539,58,19,-1.34219073726999
"Bogomolov A.",1510.40918824875,155,1512.9136067283,122,1476.7718076025,23,1418.31843676434,10,1500,0,1437.94693716573,33,1519.84250822295,132,1452.43597538527,23,23,7,-1.62883889640239,132,56,2.04520642635239
"Veronelli D.",1493.99795065643,5,1489.84423467604,1,1500,0,1502.30339107459,4,1500,0,1503.33234144741,4,1492.23837056398,5,1500,0,0,0,0,5,2,-0.240081973742663
"Tenconi T.",1488.08896823994,3,1500,0,1500,0,1486.16556619498,3,1500,0,1484.96523840034,3,1496.98710874436,2,1490.47403248098,1,1,0,-0.331616039300169,2,1,-0.144825231102065
"Almagro N.",1635.19733807403,629,1597.88846820937,200,1494.85542380558,26,1700.48015460735,396,1489.30873135623,7,1680.49386927029,429,1608.0128478649,521,1652.54467687823,108,108,63,0.0876235427783056,521,308,5.32026998018284
"Ascione A.",1499.02987091967,2,1501.11333282681,2,1500,0,1500,0,1500,0,1500,0,1499.66642907683,2,1500,0,0,0,0,2,1,-0.0388051632130783
"Petzschner P.",1555.71878061455,187,1535.79053752302,109,1567.12893593743,37,1490.20130275035,39,1474.7551592749,2,1560.36211127236,78,1588.41654574652,152,1490.29018732619,35,35,15,-1.37009461003075,152,71,3.59884583461282
"Iwami T.",1469.76455546728,4,1470.33294532292,4,1500,0,1500,0,1500,0,1500,0,1470.02972878025,4,1500,0,0,0,0,4,1,-1.20941778130875
"Iwabuchi S.",1435.31346409116,13,1434.65865676364,13,1500,0,1500,0,1500,0,1500,0,1433.56792221347,13,1500,0,0,0,0,13,3,-2.58746143635342
"Ferrero J.",1480.70959761661,4,1487.56042695705,1,1500,0,1491.35441972643,1,1499.87526002089,2,1493.46366375544,3,1480.98793961147,4,1500,0,0,0,0,4,1,-0.771616095335572
"Muller G.",1774.95263652868,321,1709.2273288345,216,1612.98773124083,58,1481.48043302887,40,1460.43680355145,7,1638.20170441484,105,1771.33846773165,260,1551.2889223258,61,61,27,4.77257518752497,260,132,6.22553027362236
"Hemmes F.",1486.75441476546,4,1504.52914462684,2,1489.99694922962,1,1487.06032439041,1,1500,0,1478.79454088836,2,1484.45719209692,4,1500,0,0,0,0,4,1,-0.529823409381626
"Kucera V.",1515.10910403346,2,1512.04468496686,2,1500,0,1500,0,1500,0,1500,0,1514.31521597772,2,1500,0,0,0,0,2,1,0.604364161338302
"Patience O.",1413.26716268405,79,1418.35093158481,18,1497.7789178627,6,1436.76305901625,54,1487.01405543238,1,1429.59487932586,61,1419.23853505893,59,1432.53365944215,20,20,6,-0.320245999737228,59,20,-3.1490674929009
"Mayer F.",1663.11172584416,429,1610.37446933833,211,1656.83659019569,52,1546.76778249689,158,1479.84271930423,8,1657.70636314349,218,1679.74070501863,354,1524.99560585658,75,75,36,1.66537469974948,354,178,4.85909433401687
"Hippensteel K.",1484.38622765804,4,1476.06517518427,4,1500,0,1500,0,1500,0,1500,0,1491.19294992331,3,1486.36925190264,1,1,0,-0.308504260118372,3,1,-0.316046633559894
"Ramirez-Hidalgo R.",1368.3308221077,185,1400.91356213459,36,1419.22844299221,8,1391.21495996822,139,1477.46399431258,2,1363.48301924942,149,1371.12787087125,160,1387.65015232372,25,25,5,-2.8669092675149,160,57,-2.39985784817683
"Monaco J.",1713.23247343535,573,1640.8143928683,196,1485.2865728025,16,1701.53484330352,352,1472.41406169832,9,1696.09404999399,377,1726.90408196916,498,1502.13102537954,75,75,31,-11.1349196339465,498,292,19.6642185713604
"Baker B.",1498.25477514487,59,1433.27504296949,39,1515.06621204608,10,1526.37893602602,10,1500,0,1538.18036415061,20,1483.52991132565,40,1482.86274501003,19,19,7,1.14394870327244,40,13,-1.21375769747778
"Cakl T.",1457.7188415942,12,1446.17600003789,7,1500,0,1499.45559394697,2,1494.92451050903,3,1499.95730119593,5,1456.64864040616,12,1500,0,0,0,0,12,3,-1.69124633623202
"Hernych J.",1584.91948543169,191,1502.66732580327,96,1527.0687953865,40,1456.85693246099,40,1504.96913325505,15,1544.79710614862,95,1565.44067848097,161,1471.21337304191,30,30,10,-0.0507483740371741,161,69,3.44752779130468
"Rocha D.",1499.03535515297,3,1500,0,1500,0,1497.80166701392,3,1500,0,1495.96051646467,3,1499.0051408338,3,1500,0,0,0,0,3,1,-0.0385857938811727
"Robert S.",1537.88178075949,97,1495.35787144816,50,1472.44179808674,9,1502.29693337395,38,1500,0,1505.81713144296,47,1523.61548449896,68,1476.72345838996,29,29,10,1.00760619028026,68,26,0.507665040099407
"Devilder N.",1445.59965130902,70,1439.25657458495,19,1481.99329945153,6,1469.4797834607,43,1474.42438004606,2,1450.36278939719,51,1400.99886989046,54,1487.51951672069,16,16,6,1.43825573516773,54,17,-3.61426968280685
"Chela J.",1514.56225499242,6,1500,0,1500,0,1520.07977041821,5,1487.0228939255,1,1511.40026310364,6,1513.4007513228,6,1500,0,0,0,0,6,3,0.582490199696702
"Pashanski B.",1454.86334893198,72,1494.65520413935,16,1468.19066109382,3,1445.50204799701,51,1499.73835768501,2,1431.43131573832,56,1480.96976880516,63,1431.99257904908,9,9,1,-1.56264355859521,63,23,-0.242822484125576
"Ventura S.",1429.55519873997,97,1407.77172501093,12,1421.76677741473,7,1493.8437158845,78,1500,0,1446.94240053572,85,1463.66436185386,86,1408.8527538964,11,11,1,-3.18242108912095,86,37,0.36462903871968
"Vagnozzi S.",1494.99671489309,11,1500,0,1500,0,1493.02627348127,11,1500,0,1491.24040167171,11,1493.34712430086,11,1500,0,0,0,0,11,4,-0.200131404276516
"Guzman J.P.",1434.57891674153,21,1485.75519811772,3,1486.71667462987,1,1451.07557191677,17,1500,0,1441.62908930493,18,1455.89634963208,18,1464.86338871186,3,3,0,-0.935891488939209,18,6,-1.68095184139965
"Koellerer D.",1472.39290191669,52,1498.99562837537,18,1448.50889241916,4,1478.66029300289,30,1500,0,1446.44616636268,34,1487.90070766368,45,1468.75118677874,7,7,2,-0.793112114189751,45,17,-0.311171809142827
"Haehnel J.",1444.8737550799,26,1523.01711976262,10,1466.40950978924,3,1435.61332828078,10,1491.58521173863,3,1409.92735994019,16,1469.30171806164,20,1459.5022834924,6,6,1,-1.24336548025199,20,7,-0.961684316551888
"Jeanpierre J.",1523.04871390824,5,1506.08398293749,2,1500,0,1509.82647366621,3,1500,0,1510.58377380681,3,1504.95641061038,2,1508.16297980242,3,3,2,0.699951921484097,2,1,0.221996634845672
"Garcia-Lopez G.",1542.59087899891,572,1501.94842036795,270,1474.32920669503,54,1655.37817725856,240,1466.35287504666,8,1610.25187940883,302,1538.71178466901,484,1523.07165558964,88,88,39,-1.83538887602559,484,229,3.5390240359818
"Starace P.",1521.24200607707,334,1409.20579641576,79,1405.2853060996,12,1555.5886744536,230,1443.69681170877,13,1531.41682538452,255,1541.81862363566,292,1367.61638687405,42,42,9,-8.18220505122108,292,137,9.03188529430379
"Falla A.",1507.07870013591,251,1489.91941345762,147,1486.30032021712,40,1480.35925900682,59,1522.78323876737,5,1502.26586650586,104,1521.48239380852,196,1459.59768908688,55,55,21,2.67977343861463,196,74,-2.39662543317804
"Chiudinelli M.",1484.6869930603,121,1455.66521807601,81,1490.11859947647,14,1467.4665790672,21,1463.60256528756,5,1467.27451915407,40,1470.1413696218,104,1507.71965618386,17,17,8,2.08498242600123,104,33,-2.69750270358907
"Seppi A.",1616.47349101556,597,1559.84155392823,292,1632.87794972057,80,1604.64129753072,206,1419.62090911817,19,1650.59150214619,305,1581.98753396022,504,1644.96068371239,93,93,45,0.950778186312509,504,242,3.7081614543099
"Marray J.",1474.98189429902,12,1489.89752602008,1,1475.1826463137,11,1500,0,1500,0,1481.83187340817,11,1500.7185485131,9,1471.78801932133,3,3,0,-1.14258429463461,9,4,0.141860066595556
"Whitehouse W.",1489.69993570302,10,1496.65440819971,7,1494.78534297806,3,1500,0,1500,0,1491.63708467235,3,1487.99756699451,10,1500,0,0,0,0,10,4,-0.412002571879026
"Lu Y.H.",1643.56945747069,324,1595.11224901608,242,1553.89016937397,59,1446.85328957472,22,1488.78178357966,1,1548.59605924064,82,1648.22355927994,260,1464.7298960748,64,64,22,-1.66012400472959,260,111,7.40290230355725
"Ancic I.",1525.599611268,3,1500,0,1518.76347173794,3,1500,0,1500,0,1521.09628882298,3,1523.92301161337,3,1500,0,0,0,0,3,2,1.02398445071985
"Flanagan I.",1524.24283044579,3,1500,0,1520.87251461716,3,1500,0,1500,0,1522.02667485126,3,1521.94071802988,3,1500,0,0,0,0,3,2,0.969713217831414
"Bracciali D.",1508.35673660978,80,1452.83292275119,30,1514.04769312164,14,1513.27757024734,23,1477.96088476059,13,1517.09416015687,50,1513.05570209682,64,1449.83496764138,16,16,5,-1.21607723301373,64,26,1.55034669740489
"Pescosolido S.",1464.06063646596,7,1493.76550157946,1,1490.26689943216,3,1470.40279636325,3,1500,0,1463.14283624989,6,1456.39635851828,5,1499.77295292921,2,2,1,0.221147310725143,5,0,-1.65872185208672
"Hilton M.",1478.75284752424,5,1500,0,1465.08228024381,5,1500,0,1500,0,1473.03857616618,5,1489.94324961811,1,1484.857534411,4,4,1,-0.453542772951711,1,0,-0.396343326078513
"Verdasco M.",1511.23563101609,2,1500,0,1500,0,1504.75647488608,2,1500,0,1508.48485736083,2,1509.97443036634,2,1500,0,0,0,0,2,1,0.449425240643695
"Vassallo-Arguello M.",1429.91585574722,125,1387.30671367295,25,1468.91713783064,7,1497.11815236865,93,1500,0,1491.10115687474,100,1439.86456130122,101,1448.30545340203,24,24,8,-0.129648328916784,101,39,-2.67371744119442
"Beck A.",1432.66103502368,98,1459.67061209578,34,1517.47987165723,14,1430.20222544635,48,1499.33171409891,2,1450.31431252427,64,1430.74597714184,76,1473.24588034738,22,22,8,-0.0492064788325084,76,30,-2.64435212022034
"Schukin Y.",1498.81167137903,32,1432.26184836929,6,1500,0,1546.10459468618,25,1487.17458554481,1,1537.98733208147,26,1497.84678415108,29,1487.58516972003,3,3,1,-0.255823780881005,29,11,0.208290636042189
"Minar I.",1482.37808670834,96,1531.82098717388,42,1442.40778683767,13,1448.04438864212,39,1475.88914601584,2,1413.46560765706,54,1475.97883795899,80,1450.11248049942,16,16,4,-1.17696302080284,80,29,0.472086489136373
"Serra F.",1463.86630396927,291,1441.91482955002,145,1435.58495466135,26,1526.62519782576,104,1453.5303480546,16,1494.82957934494,146,1470.33244774252,237,1457.97250142919,54,54,20,-0.317429881600583,237,101,-1.12791795962845
"Kubot L.",1514.95750450394,198,1440.63592018258,93,1528.7510833939,23,1514.95757370493,81,1487.03493699592,1,1543.14248791359,105,1476.7072594594,158,1524.7659376515,40,40,20,4.30014146661265,158,60,-3.70184128645504
"Baghdatis M.",1698.11270520047,525,1681.09697187316,349,1593.20380853166,79,1476.60080069472,75,1597.36231503956,22,1595.15824889831,176,1668.96907009311,419,1603.91237720768,106,106,61,7.64155518554045,419,228,0.282953022478116
"Tsonga J.W.",1929.00456998497,533,1872.12414520229,353,1730.12243278578,57,1760.21185583767,105,1590.90556492136,18,1813.29876748572,180,1864.60899945463,390,1866.48742989259,143,143,108,15.8825611853492,390,255,1.27762161404942
"Lu H.",1504.72088877019,2,1503.84105621469,2,1500,0,1500,0,1500,0,1500,0,1504.38606013585,2,1500,0,0,0,0,2,1,0.188835550807596
"Djokovic N.",2265.70770986844,852,2223.908952033,554,1898.65575383589,79,2127.47526845677,206,1512.90557156793,13,2158.14809648153,298,2228.65544483751,587,2147.15051588767,265,265,228,16.7327607847988,587,481,13.8955476099389
"Boeker M.",1485.65553386195,5,1487.82675607042,4,1500,0,1492.98005124633,1,1500,0,1495.82843090279,1,1492.87679857677,4,1489.83598084748,1,1,0,-0.285384163128644,4,1,-0.288394482393227
"Roger-Vasselin E.",1557.05236166049,208,1560.30616625507,118,1502.07607195664,35,1468.2996482728,54,1487.16236057292,1,1497.28858871986,90,1530.91614825678,168,1486.1325662541,40,40,15,1.06100073070185,168,69,1.22109373571751
"Zhu B.Q.",1463.55576730482,5,1467.77170989813,5,1500,0,1500,0,1500,0,1500,0,1463.63579060114,5,1500,0,0,0,0,5,1,-1.45776930780714
"van Gemerden M.",1495.775612767,10,1493.97700863991,3,1501.76234779421,2,1499.23603030867,5,1500,0,1498.34773436929,7,1509.11377493072,6,1480.85761437228,4,4,1,-0.562629884752222,6,3,0.39365439543229
"Wang Y.T.",1506.77689286693,40,1494.47581994511,25,1492.86829814832,12,1467.9746127756,3,1500,0,1478.57974183328,15,1491.60947093918,30,1479.21699686741,10,10,3,0.126483435385753,30,11,0.144592279291386
"Monfils G.",1871.75812084297,585,1825.81732656431,357,1592.51632483911,49,1775.8114376231,167,1527.69666462129,12,1760.79669680478,228,1837.87610801539,465,1761.24155581383,120,120,83,8.25933283176723,465,290,6.61099200195147
"Kunitsyn I.",1421.081286368,230,1433.81814682772,137,1432.78126200321,37,1434.784791826,29,1584.83879664222,27,1450.31151966355,93,1429.88554868649,199,1422.58264366372,31,31,8,-3.66031874675874,199,77,0.50357020147887
"Ryderstedt M.",1486.41658478796,20,1501.16024541025,12,1500,0,1486.60834518531,8,1500,0,1482.9659210281,8,1484.34999129171,20,1500,0,0,0,0,20,8,-0.5433366084818
"Vico U.",1482.05358153039,7,1501.69800593847,4,1492.46448352376,1,1492.08963765833,1,1487.10973685201,1,1470.41002515714,3,1481.79634329646,7,1500,0,0,0,0,7,2,-0.717856738784266
"Reynolds B.",1440.74392091432,100,1402.64703872894,74,1446.85109073811,17,1493.50533848611,8,1493.84531039771,1,1464.38287390331,26,1430.49111544329,76,1449.00303191451,24,24,7,0.464955031640845,76,21,-2.83519819506804
"Healey N.",1478.91367890819,18,1470.2339433614,15,1499.78294559373,2,1492.26662162492,1,1500,0,1493.94384821524,3,1457.86431079304,12,1504.15754239146,6,6,3,1.04668782432614,12,3,-1.89014066799836
"Widom T.",1524.75544223871,10,1519.18179147871,10,1500,0,1500,0,1500,0,1500,0,1523.09437844635,10,1500,0,0,0,0,10,5,0.990217689548263
"Sun P.",1462.65414276663,5,1462.25169070017,5,1500,0,1500,0,1500,0,1500,0,1462.15678315066,5,1500,0,0,0,0,5,1,-1.49383428933474
"Gabashvili T.",1521.63626838644,300,1486.55439695182,155,1428.95578101628,22,1525.98484933466,103,1464.91798297248,20,1507.21511623557,145,1495.29408354449,251,1493.95036430088,49,49,18,1.60205671055953,251,91,-0.736605975101941
"Stakhovsky S.",1553.08737713822,305,1550.97097762983,179,1525.25187340867,43,1455.43049151041,65,1555.16895994913,18,1515.71061498118,126,1528.28394690752,254,1512.70044839808,51,51,20,-0.742372403310706,254,113,2.86586748883925
"Simon G.",1758.86431718815,655,1728.64271935272,379,1614.78317101005,61,1669.64022667326,200,1505.76537903774,15,1696.22701991935,276,1741.06405992332,543,1720.00461183984,112,112,71,5.70199251746635,543,319,4.65258017005963
"Luczak A.",1519.07191007604,1,1500,0,1500,0,1519.7025177735,1,1500,0,1518.40306063527,1,1519.10420601743,1,1500,0,0,0,0,1,1,0.762876403041542
"Navarro-Pastor I.",1466.71397839304,100,1421.18062314847,24,1472.44636641866,17,1477.6344080097,58,1491.70451225892,1,1479.05061551716,76,1470.42810401768,89,1455.59759468,11,11,2,-1.18050396776003,89,33,-0.150936896518471
"Fogues F.",1500.33593565116,3,1500,0,1500,0,1495.48708876493,3,1500,0,1494.51377658265,3,1498.03881557015,3,1500,0,0,0,0,3,1,0.013437426046347
"Mertinak M.",1445.82310543912,15,1500,0,1481.57916574244,6,1468.96262045853,8,1486.22124115822,1,1442.79553980375,15,1450.98495540222,14,1488.30428867075,1,1,0,-0.349160605430166,14,4,-1.81791517700498
"Vik R.",1449.70799517694,55,1473.48312972658,21,1469.51989434631,5,1497.79680358692,20,1495.3406890309,9,1461.52236680663,34,1460.31387247442,48,1461.82671452227,7,7,1,-1.18038494581715,48,18,-0.8312952471054
"Dlouhy L.",1444.08695842747,66,1416.73051030973,18,1468.31008667406,7,1474.65046669441,32,1472.31682532585,9,1445.96700307653,48,1433.18520752199,52,1471.59677492718,14,14,5,1.27661674312241,52,14,-3.51313840602347
"Murray A.",2234.19039941313,754,2113.52551637074,496,1935.11593203075,106,1998.41738867684,128,1634.86126035763,24,2102.6041339624,258,2173.37199043784,541,2023.39826710046,213,213,173,11.4160040973707,541,411,17.9516118791546
"Rettenmaier T.",1507.21014504698,4,1501.7475446878,2,1501.9063754018,2,1500,0,1500,0,1500.50253996468,2,1506.68836213507,4,1500,0,0,0,0,4,2,0.288405801879273
"di Mauro A.",1415.96560698234,49,1483.59934501292,4,1486.11059814343,3,1411.43383301164,42,1500,0,1406.306748442,45,1425.29445764311,41,1458.91696684557,8,8,2,-0.483864979840476,41,12,-2.87751074086595
"Sherwood D.",1505.13671374288,2,1500,0,1500.38395260895,2,1500,0,1500,0,1501.21387969545,2,1500,0,1502.0625900377,2,2,1,0.205468549715206,0,0,0
"Bozoljac I.",1454.00668311678,25,1438.30840573038,8,1478.27260816656,9,1497.38013040308,5,1512.6557926452,3,1497.78228191794,17,1431.26068929187,16,1509.28721140637,9,9,4,1.04733147156522,16,4,-2.88706414689418
"Chadaj A.",1500.94644796231,2,1500,0,1500,0,1501.66751257195,2,1500,0,1500.65118902629,2,1500.23734347722,2,1500,0,0,0,0,2,1,0.0378579184924865
"Jenkins S.",1452.12593235302,20,1444.30147263789,13,1500.51859425698,2,1488.12860163727,5,1500,0,1486.75062686567,7,1468.55075131278,13,1466.22904167524,7,7,1,-0.701420655618774,13,4,-1.21354205026043
"Ram A.",1428.77177363161,10,1433.06291024903,8,1488.3071152272,1,1500,0,1488.70657867921,1,1484.34545649552,2,1442.9834588627,8,1477.90918756238,2,2,0,-0.613221089063449,8,1,-2.23590796567227
"Capdeville P.",1417.68670607506,102,1452.53631530712,54,1440.05561704693,9,1443.39216152457,39,1500,0,1406.31669832453,48,1418.63591890632,84,1472.79916113101,18,18,7,1.00095424260763,84,28,-4.29348599960534
"Lammer M.",1473.87229398773,20,1505.5204937967,11,1500,0,1445.40716499362,8,1489.69730655095,1,1439.10721286994,9,1465.30144387948,17,1497.90110413285,3,3,1,0.231437073289924,17,4,-1.27654531378091
"Wang Y. Jr",1499.56801706796,2,1498.57033051615,2,1500,0,1500,0,1500,0,1500,0,1499.5469745426,2,1500,0,0,0,0,2,1,-0.0172793172815153
"Matsui T.",1513.96514800607,4,1509.84675723123,4,1500,0,1500,0,1500,0,1500,0,1513.57129501893,4,1500,0,0,0,0,4,2,0.558605920242621
"Gremelmayr D.",1458.47158681623,87,1440.94713431234,45,1440.01093720864,10,1523.46909312649,28,1476.76960005521,4,1456.01972392366,42,1479.24175015928,74,1443.89280862487,13,13,3,-0.951771980296287,74,28,-0.709364547054538
"Aldi F.",1442.70884009524,9,1500,0,1500,0,1451.88748807798,8,1488.14002206915,1,1439.9949279425,9,1443.23597099772,9,1500,0,0,0,0,9,1,-2.29164639619059
"Karanusic R.",1405.29019943544,49,1385.94452674645,23,1484.62177977547,10,1450.91184215237,9,1477.67672776878,7,1450.59917054732,26,1398.78917561809,33,1444.38556258534,16,16,4,-0.417948972106817,33,7,-3.37044305047571
"Eitzinger R.",1496.30628280564,9,1492.37136235671,3,1500,0,1492.68183934437,6,1500,0,1495.04639086707,6,1495.64390083257,9,1500,0,0,0,0,9,3,-0.147748687774265
"Berrer M.",1478.03310891934,231,1490.93340471335,149,1435.64606044613,24,1445.43958732317,50,1507.02715672653,8,1448.02226940622,82,1476.28397011791,198,1418.81395271357,33,33,9,-3.26459310296031,198,78,2.38591745973396
"Bopanna R.",1445.66958601982,21,1428.55907872861,13,1485.26949201083,8,1500,0,1500,0,1491.434553861,8,1440.07453984859,21,1500,0,0,0,0,21,5,-2.17321655920704
"Faurel J.C.",1469.83541465814,9,1488.24333002863,6,1486.46447942316,1,1476.59139620596,2,1500,0,1474.19329918318,3,1470.61401447027,5,1482.80032543527,4,4,1,-0.141764655700532,5,1,-1.06481875797393
"Greul S.",1532.54556883633,114,1481.54691819938,51,1474.00625841875,9,1494.64096655666,52,1498.57849455847,2,1513.57278960807,63,1549.41231031517,100,1427.9419104115,14,14,2,-2.51438291870284,100,41,3.81620567215617
"Gimeno-Traver D.",1521.95027775886,260,1382.97121032966,66,1376.5326075842,19,1553.33422509171,175,1500,0,1526.39576762695,194,1531.13483431363,224,1382.29208253248,36,36,8,-2.91341837591293,224,87,3.7914294862672
"Marcaccio G.",1497.16676587607,5,1487.47124203382,1,1500,0,1510.28669840613,4,1500,0,1507.94828836181,4,1496.97946453463,5,1500,0,0,0,0,5,2,-0.113329364957255
"Del Potro J.M.",1927.70519233454,449,1905.91932500115,315,1664.70882372834,43,1800.52564448643,78,1553.63959635125,13,1835.49553157083,134,1899.79813065075,352,1810.75215749968,97,97,69,3.5817573499189,352,247,13.5264503434626
"Aguilar J.",1473.52407838099,6,1500,0,1500,0,1471.79436333765,6,1500,0,1472.75179072977,6,1477.40118689414,5,1493.28847954409,1,1,0,-0.135406457764755,5,1,-0.923630406995781
"Cilic M.",1929.66231076306,559,1872.01104664337,333,1735.03079823611,67,1711.09579573815,138,1573.46282886202,21,1784.93876415923,226,1890.03118203625,442,1821.82664177627,117,117,83,11.0838509025609,442,279,6.10264152796127
"Korolev E.",1506.32142434439,159,1571.08763980794,84,1428.11680490866,12,1459.34140487111,55,1451.21526527287,8,1419.89680410922,75,1503.07766725152,136,1476.59938546849,23,23,7,-0.931542734695081,136,61,1.18439970847084
"Warburg S.",1492.26903116569,15,1478.92704598188,14,1489.86864736521,1,1500,0,1500,0,1491.00852622724,1,1477.96748248262,10,1494.79961210751,5,5,2,0.405800385740222,10,3,-0.715039139112637
"Wilson B.",1469.07823531029,5,1475.65523931504,4,1487.5,1,1500,0,1500,0,1487.5618659936,1,1477.89078761349,4,1489.36635428598,1,1,0,-0.364979527748656,4,1,-0.87189105983955
"Ghem A.",1476.58725266209,7,1500,0,1500,0,1479.30828563325,7,1500,0,1475.95559303076,7,1477.25207843492,7,1500,0,0,0,0,7,2,-0.936509893516559
"Meffert D.",1495.43527907623,13,1491.79655659694,7,1493.89378708114,3,1497.04946730264,3,1500,0,1495.05765681037,6,1498.32163428669,12,1488.89227657988,1,1,0,-0.391477134937467,12,5,0.208888297986508
"Klec I.",1469.66777394779,8,1475.04439096085,5,1500,0,1490.9766098209,3,1500,0,1491.82326129893,3,1468.32377907389,8,1500,0,0,0,0,8,2,-1.21328904208857
"Al Ghareeb M.",1473.81236591058,7,1475.62843834623,6,1500,0,1493.27694565148,1,1500,0,1493.15774885592,1,1471.17469959534,7,1500,0,0,0,0,7,1,-1.04750536357675
"Querry S.",1473.13527464878,7,1468.62745363906,5,1501.32892266941,2,1500,0,1500,0,1500.97348528092,2,1471.97669646054,7,1500,0,0,0,0,7,2,-1.07458901404873
"Berlocq C.",1597.80870034129,269,1489.4956587511,76,1427.53890044324,19,1630.44570845721,173,1489.97057449169,1,1619.98549571633,193,1611.23105818152,230,1393.56200145887,39,39,9,-5.94663234984669,230,103,9.85898036349841
"Balleret B.",1494.81883262087,11,1497.45157595714,3,1500,0,1483.19123845967,8,1500,0,1485.86707875028,8,1490.98711177641,11,1500,0,0,0,0,11,3,-0.207246695165031
"Saoudi S.",1492.02536523137,5,1486.30200234685,1,1500,0,1500.13636213262,4,1500,0,1500.58351344705,4,1504.34950195455,4,1486.11748866729,1,1,0,-0.588992537337282,4,2,0.270007146592144
"Tahiri M.",1449.41305225518,7,1500,0,1500,0,1447.272928858,7,1500,0,1446.03872767128,7,1448.30734635728,7,1500,0,0,0,0,7,1,-2.02347790979271
"Chardy J.",1597.2934995998,407,1576.94578106107,214,1523.73837630734,37,1612.21016608201,150,1503.73511873656,6,1606.24584493402,193,1550.99342457396,328,1661.58238640992,79,79,45,8.34973683010322,328,155,-4.45799684611133
"Gil F.",1555.44301456069,115,1521.58032272392,40,1443.50525071733,8,1546.03317862294,67,1500,0,1519.2572222195,75,1549.36346433983,98,1435.18970634133,17,17,3,-3.15245936489851,98,46,5.37017994732623
"Kindlmann D.",1444.92799409512,12,1478.8130224823,5,1500,0,1448.49864729437,7,1500,0,1451.5982447275,7,1455.53568870212,5,1468.8637919173,7,7,1,-0.519542038631132,5,0,-1.68333819756407
"Montcourt M.",1502.85214548851,15,1471.27992497642,4,1500,0,1510.56144757127,11,1500,0,1512.33425766546,11,1482.82217152439,8,1506.31503807868,7,7,3,0.804259357086703,8,2,-0.690173537546163
"Zverev M.",1613.64066387497,203,1590.90215820854,109,1500.08988471954,34,1401.94995017281,48,1524.86344492258,12,1461.88766879062,94,1595.52718670005,181,1412.15176254559,22,22,5,-2.81804853633288,181,75,7.36367509133173
"Becker B.",1517.37311486368,364,1504.68127671085,249,1548.4332087917,66,1400.16056597913,43,1512.48274896782,6,1517.73080559814,115,1506.79730252653,310,1476.55054043103,54,54,19,-0.411348053229731,310,133,1.10627264777687
"Bloomfield R.",1459.84367856735,16,1479.20739309184,2,1457.97718440636,14,1500,0,1500,0,1461.97408753755,14,1468.7437693955,11,1477.4695563695,5,5,1,-0.6093380419712,11,3,-0.996914815334618
"Alves T.",1428.11934108325,30,1448.65602942109,15,1488.82278689037,5,1448.34506711456,10,1500,0,1442.80995440053,15,1410.55284797765,21,1494.89473344851,9,9,3,0.890519662734294,21,4,-3.76574601940421
"De Bakker T.",1520.93503800419,131,1493.46329925093,69,1475.63993568673,16,1531.35313061697,46,1500,0,1516.98661921434,62,1531.42371917867,112,1471.47678136126,19,19,6,-1.0629588380219,112,47,1.90036035818962
"Fognini F.",1696.43865860175,454,1625.61570916284,171,1531.00801104916,27,1694.95900811722,255,1488.2156231477,1,1687.67894760069,283,1690.46790186765,387,1568.15499218136,67,67,32,-0.608906584337625,387,193,8.46645292840782
"Querrey S.",1660.44436978799,488,1608.39583274598,329,1657.60969975101,78,1551.89558962284,76,1477.49118525339,5,1673.04403024539,159,1645.32539500065,410,1560.16265340017,78,78,39,-2.74328674875918,410,232,9.16106154027854
"Junqueira D.",1420.95166287949,43,1483.17980137688,8,1490.39299303876,1,1418.71096858445,34,1500,0,1411.17346756145,35,1401.71022110411,35,1499.75440664635,8,8,3,0.795176342908568,35,8,-3.95710982772883
"Hartfield D.",1486.70844043038,45,1464.74253125968,7,1473.10672345036,2,1510.59742831723,32,1502.39730328285,4,1501.5712915243,38,1494.12745639776,39,1475.53107186509,6,6,1,-0.607098158621251,39,16,0.0754357758363569
"Haider-Mauer A.",1499.24974295065,3,1496.0895925537,1,1500,0,1499.46543837898,2,1500,0,1503.08779839912,2,1498.04277489276,3,1500,0,0,0,0,3,1,-0.0300102819739368
"Oudsema S.",1481.19692102691,5,1490.85552685859,4,1489.23657933048,1,1500,0,1500,0,1487.8871760735,1,1480.88098783152,5,1500,0,0,0,0,5,1,-0.752123158923514
"Ianni S.",1505.32170603699,2,1500,0,1500,0,1502.70224541559,2,1500,0,1504.29905053093,2,1502.38180130315,2,1500,0,0,0,0,2,1,0.212868241479642
"Przysiezny M.",1413.17749421505,78,1434.97993290187,42,1464.50935531309,12,1391.24349683975,24,1500,0,1378.37111173679,36,1409.040638783,63,1447.41137813564,15,15,4,0.161985613234739,63,15,-3.63488584463274
"King P.",1429.55792000398,9,1425.97387525424,9,1500,0,1500,0,1500,0,1500,0,1436.30126961916,8,1487.55843562853,1,1,0,-0.371870544295045,8,1,-2.44581265554573
"Sweeting R.",1558.80827853309,89,1489.23874999636,65,1476.4558527989,10,1542.42988484656,14,1500,0,1536.91357253932,24,1548.99083273254,71,1459.55435705748,18,18,5,-1.10301350141346,71,28,3.45534464273714
"Stoppini A.",1489.90694006557,11,1498.96554984466,9,1500,0,1481.26471346874,2,1500,0,1479.67404568102,2,1490.93212210555,10,1496.90536848839,1,1,0,-0.0650251585149169,10,3,-0.338697238862297
"Hajek J.",1431.22088525032,96,1348.12818238249,45,1464.41696448649,4,1504.65626737803,46,1488.5766067821,1,1497.75050588073,51,1434.76194097537,76,1442.73720535972,20,20,5,0.325857554742607,76,21,-3.07702214472991
"Gregorc L.",1534.29514054387,13,1526.68624175236,12,1488.77182529634,1,1500,0,1500,0,1496.20789295724,1,1535.9134378331,12,1494.25345374348,1,1,0,-0.164416549732555,12,6,1.53622217148749
"Crivoi V.",1420.09468747442,41,1460.32808763097,9,1482.25402581154,3,1435.45152330037,29,1500,0,1427.73945296441,32,1423.02683022088,35,1483.40352553366,6,6,2,-0.325176750028661,35,10,-2.87103575099436
"Ledovskikh M.",1441.53792585876,17,1478.45245481586,8,1460.45194076899,5,1486.24244646599,1,1487.10719048487,3,1449.87824191984,9,1441.40717874892,17,1500,0,0,0,0,17,4,-2.3384829656497
"Auckland J.",1519.38861844402,3,1519.07229135436,3,1500,0,1500,0,1500,0,1500,0,1517.13527593019,3,1500,0,0,0,0,3,2,0.775544737760955
" Hajek J.",1505.35761627486,2,1500,0,1500,0,1503.86587336244,2,1500,0,1503.41236079493,2,1504.46096451592,2,1500,0,0,0,0,2,1,0.214304650994209
"Naso G.",1437.69162757108,14,1500,0,1500,0,1428.75107309732,14,1500,0,1427.39931159607,14,1438.05205403455,14,1500,0,0,0,0,14,3,-2.49233489715682
"Clemens T.",1505.39110011727,4,1512.48684416552,3,1500,0,1500,0,1487.5,1,1487.5768444278,1,1503.96343816118,4,1500,0,0,0,0,4,2,0.215644004690737
"Troicki V.",1710.14890857301,436,1671.72475536727,271,1586.70100736764,50,1620.72085395505,103,1518.08864138934,12,1648.19067349194,165,1685.04666444372,363,1640.95309887605,73,73,43,3.01123265535537,363,189,5.39472368756502
"Kravchuk K.",1439.77963770944,19,1446.61102728867,12,1463.80257316031,3,1500.70161711551,2,1499.17260311119,2,1472.59121748948,7,1446.55775122335,17,1482.48280586008,2,2,0,-0.575460576195717,17,5,-1.83335391542651
"Gulbis E.",1577.32690710262,395,1553.91622238754,235,1469.68852267332,29,1634.23513153543,118,1517.5005298026,13,1605.43124077432,160,1548.98903042726,328,1545.76657172904,67,67,31,-0.656223070088104,328,166,3.74929935419307
"Robredo R.",1518.18749974829,3,1513.65076195271,3,1500,0,1500,0,1500,0,1500,0,1516.37254803195,3,1500,0,0,0,0,3,1,0.727499989931784
"Jones A.",1457.34608530143,11,1444.43738776598,11,1500,0,1500,0,1500,0,1500,0,1469.45626045843,5,1471.11608228229,6,6,1,-0.653589747567054,5,1,-1.05256684037579
"Rastogi K.",1474.95091830532,5,1474.1895210151,5,1500,0,1500,0,1500,0,1500,0,1473.56405722865,5,1500,0,0,0,0,5,1,-1.00196326778727
"Sela D.",1545.40458141137,247,1503.15821202002,164,1523.4644104061,47,1398.09597541869,34,1500.05779887495,2,1506.57715818895,83,1539.97998414252,193,1459.3956834589,54,54,19,0.817617676217749,193,83,0.998565580236999
"Smeets R.",1460.57783267259,9,1457.74621593902,8,1500,0,1492.74563063463,1,1500,0,1495.26098476866,1,1462.06242307832,4,1482.54763110472,5,5,1,-0.1036589304301,4,0,-1.47322776266647
"Kuznetsov A.",1429.10473567614,26,1398.69059466887,19,1490.41006649229,5,1497.90560910026,2,1500,0,1499.69975258126,7,1433.23100402513,20,1472.10191912265,6,6,1,-0.187428516075078,20,5,-2.64838205687953
"Levine J.",1490.29578163035,93,1461.31398260399,63,1475.58476734807,23,1449.47516987031,7,1500,0,1457.86297884942,30,1454.74454844223,70,1490.17240950822,23,23,9,2.14383335248453,70,21,-2.53200208727066
"Haase R.",1587.35225271008,315,1498.25960142253,153,1502.77067030724,34,1569.90594171566,125,1514.45001454527,3,1592.07624916519,162,1592.24700520437,269,1468.70755884427,46,46,15,-1.16726573185802,269,125,4.66135584026129
"Bolelli S.",1618.11436525222,246,1521.57819033764,108,1543.05025892966,27,1609.90519779119,97,1512.21961760054,14,1641.08639690291,138,1600.26265071314,196,1539.55433609128,50,50,22,4.24184093463898,196,81,0.482733675449808
"Granollers M.",1637.10378697899,395,1585.88257504706,170,1479.9184251244,27,1573.56265007513,195,1492.21562572708,3,1582.31186749678,225,1578.424899268,323,1609.13149606601,72,72,35,4.44680854409479,323,150,1.03734293506459
"Andujar P.",1535.3972259894,285,1424.91061766021,102,1403.70655249527,16,1616.98266196687,167,1500,0,1606.60104524868,183,1527.53403665075,244,1465.62851749836,41,41,14,-1.44074138057672,244,102,2.8566304201529
"Gensse A.",1492.26268995495,4,1494.52045490485,1,1500,0,1495.57416805506,3,1500,0,1495.06700624887,3,1500.15140192558,2,1483.71867241472,2,2,0,-0.311125327723833,2,1,0.00163292592165276
"Stepanek M.",1512.12138446274,2,1500,0,1500,0,1506.6591742103,2,1500,0,1509.52130954675,2,1511.6632552542,2,1500,0,0,0,0,2,1,0.484855378509408
"Lorenzi P.",1597.62490977845,183,1517.45774682213,73,1401.29276319474,17,1568.40640761602,93,1500,0,1524.48554609173,110,1587.39034906574,157,1404.4176279606,26,26,4,-2.64048404809303,157,63,6.5454804392311
"Brands D.",1538.06934211604,143,1514.01738474016,75,1494.7171821356,15,1521.67251444947,53,1500,0,1519.71216578606,68,1547.52475260862,119,1453.57104824564,24,24,7,-0.809814653963347,119,49,2.33258833860504
"Bachinger M.",1499.76222401702,69,1478.58957053806,36,1467.91159675916,8,1461.85311969494,25,1500,0,1453.22381894498,33,1492.34623353083,59,1456.71589101444,10,10,2,-0.876049118503408,59,21,0.866538079184294
"Summerer T.",1448.89127176425,9,1486.9091540602,2,1491.45831777655,1,1463.34279913903,6,1500,0,1459.73976966574,7,1457.52309364827,7,1476.71856927473,2,2,0,-0.433147033876693,7,1,-1.61120209555335
"Economidis K.",1410.99878066638,12,1437.83359989819,6,1467.47961870918,3,1496.13672407506,3,1500,0,1462.99129269784,6,1417.92932596661,7,1475.9675877652,5,5,1,-0.370133091994857,7,0,-3.18991568135012
"Recouderc L.",1442.07350827038,15,1440.93305617878,8,1500,0,1483.15537826401,7,1500,0,1487.73496037048,7,1448.84606072461,10,1476.14845200692,5,5,1,-0.365747308600775,10,2,-1.95131236058416
"Brzezicki J.P.",1452.56388859432,23,1465.30206892742,3,1500,0,1481.37123001217,20,1500,0,1477.60754233563,20,1456.82865699317,17,1482.83940532675,6,6,2,-0.00144082350956298,17,5,-1.89600363271744
"Cipolla F.",1455.15941284089,101,1468.81952281971,55,1438.07957670332,8,1451.86397449263,38,1500,0,1433.74246807093,46,1457.51790482273,82,1479.17027596644,19,19,7,0.656750471705731,82,28,-2.4503739580701
"Qureshi A.",1506.33584772974,10,1487.86853037562,1,1504.78634002148,9,1500,0,1500,0,1511.55048875972,9,1499.80975540995,8,1506.50118508263,2,2,1,0.149030731807156,8,3,0.104403177382481
"Stadler S.",1508.13712098501,16,1498.21227709596,8,1487.95484558758,8,1500,0,1500,0,1497.02864131006,8,1497.30100752021,11,1495.1879638895,5,5,2,0.397995670238823,11,4,-0.0725108308385936
"Baker J.",1421.32614958486,19,1479.94580747419,2,1413.10625937158,17,1500,0,1500,0,1419.18578996441,17,1463.09314795194,12,1424.56716280399,7,7,0,-2.14113669755683,12,3,-1.00581731904872
"Guccione A.",1493.44122120175,3,1500,0,1495.5849518306,2,1486.88701503109,1,1500,0,1492.42926236873,3,1486.63722816743,1,1505.26640550382,2,2,1,0.322582158671234,1,0,-0.584933310601294
"Darcis S.",1580.82273500038,162,1556.26175656489,84,1530.71072637722,21,1500.76260995118,54,1518.65469343587,3,1539.42654133554,78,1576.06748907141,126,1487.27406777671,36,36,12,-0.746412884199767,126,60,3.97932228421516
"Nishikori K.",1978.05526980817,412,1914.92892325407,288,1629.21516605547,41,1872.11119110751,83,1500,0,1892.7863408733,124,1944.26946104584,324,1814.13184052545,88,88,60,4.38451722099751,324,216,14.7376935713291
"Riba P.",1396.36066977712,84,1396.08620188887,20,1452.34179623193,4,1442.33984185659,60,1500,0,1424.2838650269,64,1409.35389863874,69,1439.39425372355,15,15,4,-0.563439289973037,69,20,-3.58213391894218
"Klizan M.",1617.14846885738,189,1561.3804368337,98,1464.38026662153,13,1642.42125132034,78,1500,0,1618.63659351426,91,1641.65088997694,155,1495.47219968042,34,34,14,-0.154086127537054,155,77,4.84002488183219
"Isner J.",1823.74493152404,488,1814.80441135045,353,1619.17796824414,46,1637.87337754742,89,1500,0,1665.31418883907,135,1798.34260533753,399,1706.03131746435,89,89,55,-0.959182733781817,399,250,13.9089799947436
"Odesnik W.",1520.71975042176,97,1464.77997942636,61,1443.1811974475,5,1589.5572790125,31,1500,0,1542.68770125584,36,1556.60297669957,76,1422.65698151459,21,21,5,-2.26124509817293,76,35,3.0900351150433
"Young D.",1619.55551876276,246,1598.72330363454,190,1449.57971470375,29,1437.75991542463,27,1500,0,1459.41138932735,56,1601.14965313355,199,1484.0491078041,47,47,17,1.37615647356742,199,79,3.40606427694314
"Lindahl N.",1451.58251179746,9,1453.98275944167,8,1500,0,1488.84557317082,1,1500,0,1489.65646031541,1,1460.49566615427,7,1483.57231598669,2,2,0,-0.536791748852204,7,1,-1.39990777924939
"fnisk",1517.04103459747,1,1515.23056436418,1,1500,0,1500,0,1500,0,1500,0,1516.972021507,1,1500,0,0,0,0,1,1,0.681641383898643
"Prpic F.",1454.4754436112,10,1489.29666995926,5,1500,0,1446.55022471411,5,1500,0,1447.50549292427,5,1453.42638137424,10,1500,0,0,0,0,10,2,-1.82098225555183
"Golubev A.",1468.59837703245,158,1447.93653677802,91,1421.45469123313,11,1483.59564426515,49,1544.99287297835,7,1478.3633368569,67,1470.94892931606,134,1423.80578158175,24,24,4,-1.80763283980184,134,47,0.551567921099982
"Matsukevitch D.",1487.86669799853,4,1500,0,1500,0,1489.39841166557,1,1495.34352816555,3,1485.31974013745,4,1487.02786986778,4,1500,0,0,0,0,4,1,-0.485332080058906
"Zovko L.",1478.20657230121,8,1489.95710489462,3,1500,0,1481.16254059796,2,1493.50484194168,3,1482.04124247205,5,1477.79811143349,8,1500,0,0,0,0,8,2,-0.871737107951528
"Kudryavtsev A.",1454.24925568568,20,1476.99019957034,15,1479.01459187872,2,1486.71538467027,1,1475.98486424389,2,1451.98564131515,5,1464.69776027581,15,1470.49331544045,5,5,1,-0.519393072376716,15,4,-1.31063670019619
"Istomin D.",1554.62335354373,357,1509.52211027573,218,1586.96368282856,56,1519.29682032074,80,1487.19328386986,3,1590.12390340643,139,1525.31939067227,294,1562.77039182886,63,63,30,5.91845900596612,294,132,-3.7335248642169
"Cuevas P.",1673.85579360132,262,1523.36071193001,91,1505.0423160182,13,1751.52282811297,158,1500,0,1728.01572867785,171,1680.17826318306,227,1473.19290214876,35,35,12,-5.27439202747016,227,123,12.2286237715231
"Marrero D.",1467.37951156475,9,1500,0,1500,0,1469.18445665775,9,1500,0,1467.32032320207,9,1461.82613647872,7,1506.0207209649,2,2,1,0.36753650973727,7,2,-1.67235604714734
"Schwank E.",1513.31232208233,98,1457.88544712771,27,1442.1783386949,8,1537.30924644332,62,1488.81777174051,1,1513.96706840256,71,1474.32547102751,81,1493.75164166572,17,17,6,0.820015941167172,81,31,-0.28752305787404
"Decoud S.",1522.21455186489,8,1500,0,1488.74967988304,1,1537.87575436334,7,1500,0,1519.48541838785,8,1514.8411460104,6,1498.97875311722,2,2,1,0.450899487812525,6,3,0.437682586783
"Bellucci T.",1623.88670982044,337,1564.13637368981,143,1483.8801258322,15,1609.23615176333,179,1500,0,1597.60587796212,194,1621.17478263533,284,1496.06989094029,53,53,22,-2.0150499434099,284,141,6.97051833622761
"Anderson K.",1719.74583301307,408,1700.04214890103,283,1610.99868612782,47,1622.00911109597,78,1500,0,1678.34552897061,125,1704.43975859441,333,1686.0629199423,75,75,44,2.49944525698158,333,186,6.29038806354112
"Giraldo S.",1538.8123042794,307,1495.58717715882,138,1476.38427196074,28,1556.87357946784,140,1490.4632951905,1,1539.43968992876,169,1552.60802668956,265,1417.87630083089,42,42,12,-5.3444165827882,265,123,6.89690875396435
"Sousa J.",1634.46689353669,215,1585.48729357873,116,1500.74918474657,18,1614.50924808411,81,1500,0,1613.67506833504,99,1597.77841823916,185,1578.59147541281,30,30,15,3.67100384636608,185,85,1.70767189510167
"Machado R.",1401.5716876164,50,1430.46690483234,11,1487.44960714854,1,1426.7363891325,38,1500,0,1420.32569426972,39,1422.67339211242,38,1429.76766138371,12,12,2,-1.29618054891144,38,11,-2.64095194643259
"Harrison R.",1618.80489797891,174,1608.71800587919,131,1467.28314294899,27,1455.88464373396,16,1500,0,1459.78862190878,43,1592.50318978747,146,1473.98063696774,28,28,8,0.56722531768337,146,64,4.18497060147315
"Trujillo G.",1506.55888366357,2,1500,0,1500,0,1508.29535794729,2,1500,0,1507.7612227904,2,1506.04069484859,2,1500,0,0,0,0,2,1,0.262355346542905
"Kukushkin M.",1548.00746160399,207,1552.78606302543,131,1461.08834334323,18,1455.38150695723,54,1476.08558329644,4,1460.84635210463,76,1535.83753343825,171,1488.06600039761,36,36,14,1.42842323540991,171,70,0.491875228749648
"Del Potro J.",1522.1909501761,3,1500,0,1500,0,1518.60412202292,3,1500,0,1520.10184574001,3,1521.82689384354,3,1500,0,0,0,0,3,2,0.887638007043836
"Sidorenko A.",1487.75892952819,13,1482.7356735363,6,1500,0,1498.92952104112,7,1500,0,1497.0857702931,7,1497.42615984473,11,1481.89082500734,2,2,0,-0.893022813725096,11,5,0.403379994852571
"Ouahab L.",1474.89908294416,13,1478.20451525522,2,1500,0,1488.28827229568,11,1500,0,1488.19829010967,11,1481.73524881357,12,1488.00387457355,1,1,0,-0.523990411655495,12,4,-0.4800462705779
"Kavcic B.",1491.16210625793,106,1515.03411071655,46,1411.52512296042,11,1476.19890850587,48,1487.03331298807,1,1441.06912949179,60,1449.40435944522,76,1511.34275903317,30,30,12,2.88494368744886,76,25,-3.2384594371317
"Lopez-Jaen M.A.",1507.54664172569,3,1500,0,1500,0,1504.26195332928,3,1500,0,1503.44858241806,3,1494.48558278158,1,1508.59884314003,2,2,1,0.534289838572881,1,0,-0.232424169545121
"Gonzalez M.",1419.87125127097,84,1427.95728209517,16,1460.28528383485,4,1449.07553218549,64,1500,0,1433.54996494451,68,1437.56229240878,65,1441.7160812111,19,19,5,-0.993078789421391,65,22,-2.2120711597398
"Dell'Acqua M.",1477.34455060266,6,1478.66817811552,2,1500.21957496554,2,1484.77064897798,2,1500,0,1494.67422505352,4,1476.7993961267,6,1500,0,0,0,0,6,1,-0.906217975893648
"Groth S.",1524.16797010745,88,1450.25872389511,56,1532.06765022667,23,1499.54497232148,9,1500,0,1553.25643814179,32,1489.63144315042,70,1521.32496981527,18,18,7,1.95702209269096,70,27,-0.990303288392981
"Eaton C.",1504.16630122063,2,1500,0,1502.9889773779,2,1500,0,1500,0,1500.0165837059,2,1500,0,1501.37192386788,2,2,1,0.166652048825361,0,0,0
"Eleskovic E.",1467.63718463141,10,1458.73884097616,4,1500,0,1497.59978771316,6,1500,0,1494.53609347487,6,1466.37909222797,10,1500,0,0,0,0,10,2,-1.29451261474375
"Bohli S.",1408.03634373075,20,1428.02011696959,9,1487.5,1,1463.39950859152,6,1477.75942696396,4,1448.74925776858,11,1413.14069225294,19,1483.03854132883,1,1,0,-0.536213138122763,19,2,-3.14233311264742
"Evans B.",1456.69343812637,21,1413.39380741968,14,1512.30427103458,7,1500,0,1500,0,1518.97545125807,7,1466.15498705222,17,1476.01866023055,4,4,1,-0.636086222189055,17,5,-1.09617625275602
"Qureshi A.U.H.",1483.27988049114,5,1474.89244521721,3,1501.51120792203,2,1500,0,1500,0,1499.80255396039,2,1488.59162278504,4,1491.43383329275,1,1,0,-0.26043652870135,4,1,-0.408368251652961
"Rosol L.",1571.86082747929,242,1551.48893580079,137,1473.9586353744,18,1569.72604775908,87,1500,0,1549.22282136538,105,1558.09669514612,205,1502.63523686801,37,37,15,-0.112210520012137,205,89,2.9866436191838
"Dabul B.",1461.95413159139,42,1482.37594850169,15,1491.39998047154,7,1458.69263342268,20,1500,0,1460.13884490007,27,1481.05154691308,34,1447.23601544942,8,8,1,-1.27721552334547,34,14,-0.244619212999037
"Huta Galung J.",1405.82217340532,30,1414.83940575183,17,1468.70123428279,8,1472.6980979705,5,1500,0,1459.10751394649,13,1429.26528380413,25,1440.88346915007,5,5,0,-1.85551040025143,25,5,-1.91160266353559
"Jun W.S.",1455.54392581101,7,1478.32832481632,5,1486.59341631322,1,1486.83284669649,1,1500,0,1472.49601326934,2,1458.53744516217,7,1500,0,0,0,0,7,1,-1.77824296755976
"Mayer L.",1592.15332581886,248,1530.82458675402,105,1510.89631675204,28,1600.8837696972,115,1500,0,1598.52019859854,143,1586.61546969223,194,1570.9796095693,54,54,26,5.25158091748265,194,89,-1.56544788472841
"Devvarman S.",1478.14755166266,114,1515.14883842993,85,1464.85572808951,10,1464.51926667088,19,1500,0,1440.52879999759,29,1501.02120814252,95,1443.18520046689,19,19,5,-3.05565245894997,95,43,2.18155452545639
"De Heart R.",1504.0112476766,3,1503.20708257513,3,1500,0,1500,0,1500,0,1500,0,1489.74960177707,1,1511.07641871637,2,2,1,0.583659243747381,1,0,-0.423209336683428
"Cruciat A.",1487.73814564379,3,1500,0,1500,0,1489.51690889482,3,1500,0,1487.56269998468,3,1489.1706751866,3,1500,0,0,0,0,3,1,-0.490474174248204
"Scherrer J.C.",1468.19585748153,5,1487.35288966281,3,1474.3016196171,2,1500,0,1500,0,1477.39278473027,2,1466.39718804522,5,1500,0,0,0,0,5,1,-1.27216570073892
"Soeda G.",1484.30485080193,98,1466.6570460009,75,1452.09382567644,15,1449.76717043023,8,1500,0,1436.24314932983,23,1478.22245315162,78,1447.81003259512,20,20,4,-0.885507163628688,78,24,0.257701195705894
"Jouan R.",1494.75942260826,5,1493.87608600065,4,1500,0,1493.33117058916,1,1500,0,1495.75631450788,1,1497.16257466915,3,1491.67135770374,2,2,0,-0.182830281352924,3,1,-0.02679281431681
"Mannarino A.",1602.17768129118,239,1552.48451105055,149,1580.21231912006,47,1485.36509066732,42,1487.04868002467,1,1596.44316078322,90,1588.51297453486,194,1521.81122311644,45,45,18,2.48567498328399,194,85,1.60143226836301
"De Voest R.",1430.47240339673,28,1431.92377989395,22,1462.41177779363,6,1500,0,1500,0,1467.33244460065,6,1446.8913822124,22,1463.5478052689,6,6,1,-0.966884372520605,22,6,-1.81421949161025
"Slanar M.",1493.4440359929,3,1491.9142532384,3,1500,0,1500,0,1500,0,1500,0,1504.04522456956,2,1487.71998819416,1,1,0,-0.451841817332593,2,1,0.189603257048413
"Ouanna J.",1515.82630800565,26,1478.18811732688,11,1500,0,1484.35609669396,11,1507.07717652271,4,1510.55535306977,15,1488.15477599786,17,1512.40524706246,9,9,4,1.04960971486008,17,5,-0.416557394633922
"Elgin M.",1452.00755018226,11,1455.83428896131,7,1500,0,1500,0,1470.64259912665,4,1484.38814316195,4,1449.56443134365,11,1500,0,0,0,0,11,2,-1.9196979927096
"Lejnieks K.",1506.90967392872,2,1500,0,1500,0,1500,0,1499.61289544442,2,1506.99521020347,2,1506.08657234427,2,1500,0,0,0,0,2,1,0.276386957148607
"Tomic B.",1693.67753253722,276,1676.47599004716,182,1607.82282136837,43,1499.94689639727,51,1500,0,1618.40287611769,94,1672.44984835802,212,1654.78515738643,64,64,37,8.62864288928808,212,105,-0.881541587799142
"Klein B.",1476.17219534034,9,1490.71116287865,4,1474.53852008935,5,1500,0,1500,0,1475.94639404249,5,1487.56735112272,4,1469.29967688589,5,5,1,-0.613804674833434,4,1,-0.339307511552776
"De Chaunac S.",1528.92899283486,10,1524.45340396255,10,1500,0,1500,0,1500,0,1500,0,1520.53091890678,8,1504.54004563567,2,2,1,0.444485147883132,8,4,0.712674565511333
"Klaasen R.",1502.43342110504,8,1488.01415034749,5,1513.56982216464,3,1500,0,1500,0,1513.13307613709,3,1504.13384271146,8,1500,0,0,0,0,8,4,0.0973368442014524
"Van der Merwe I.",1489.9599869049,3,1500.28774558948,2,1487.915951986,1,1500,0,1500,0,1485.77732971862,1,1500.19383453632,2,1486.82511504902,1,1,0,-0.462876587309293,2,1,0.061276063505398
"Veic A.",1448.36973963168,32,1459.00667653375,11,1500,0,1455.08989822115,18,1510.42897559245,3,1465.03561976256,21,1416.47935549499,27,1533.88594143357,5,5,3,1.80354910122643,27,7,-3.86875951595904
"Dodig I.",1513.37282967873,240,1477.6302272816,154,1564.39443642861,30,1556.27620453052,53,1516.84932118011,3,1594.04330541341,86,1537.31172147388,201,1498.32226900221,39,39,15,-2.59369275814818,201,97,3.12860594529741
"Dimitrov G.",1816.13354514115,338,1798.87816016908,215,1618.65429896541,45,1691.69558851725,78,1500,0,1712.1551849225,123,1789.80874808166,280,1658.12127281667,58,58,33,-1.36210307546457,280,166,14.0074448811107
"Ferreiro F.",1489.353721852,6,1500,0,1500,0,1490.54497171292,6,1500,0,1489.61493312121,6,1497.80364992771,5,1490.12712220746,1,1,0,-0.280139333455582,5,2,-0.145711792464309
"Rufin G.",1530.64726300819,43,1523.55220803487,20,1480.19868365492,6,1480.9943186746,17,1500,0,1485.04187718866,23,1497.5973366256,25,1493.25155537674,18,18,7,1.47073713690064,25,9,-0.244846616573212
"Lacko L.",1496.62955413858,165,1468.74760623495,118,1475.27147368313,30,1429.9582088037,16,1490.05236533101,1,1465.96372516998,47,1497.21768689592,126,1451.31992340254,39,39,11,-1.25535934316908,126,50,1.1205415087122
"Ward J.",1427.33623559553,59,1433.22879510264,17,1417.51914243963,36,1454.33349648622,6,1500,0,1414.11989238556,42,1416.33144043891,45,1451.74768120319,14,14,3,-0.485669681661532,45,12,-2.4208808945173
"Goodall J.",1421.70252935981,12,1489.43569815194,1,1418.56015598431,11,1500,0,1500,0,1418.41124265976,11,1470.64639668644,6,1431.07272778885,6,6,0,-2.27242551372355,6,1,-0.859473311883958
"Ball C.",1492.66742729428,20,1513.94089743599,16,1474.63492840817,2,1479.54635198389,2,1500,0,1455.67121144567,4,1541.04272205515,9,1440.19737973107,11,11,2,-2.23894213079801,9,5,1.94563922256934
"Polansky P.",1457.66006886069,27,1471.66110060447,19,1487.58850094994,1,1461.1474941217,7,1500,0,1450.03891773821,8,1457.7430560724,21,1469.79349469801,6,6,1,-0.297627567487944,21,5,-1.39596967808456
"Ilhan M.",1438.35369007336,70,1427.63634425183,41,1475.83644797666,9,1442.81607838732,20,1500,0,1444.49038094891,29,1406.49177109644,51,1492.115975054,19,19,7,1.68482913575951,51,12,-4.15068153282516
"Witten J.",1481.38309323105,10,1492.03578743833,7,1492.05091392779,1,1476.78492977096,2,1500,0,1474.65605795684,3,1464.705825103,4,1491.89199309822,6,6,2,0.503741659464003,4,0,-1.24841793022197
"Zeballos H.",1504.44724086237,151,1502.21374250255,59,1422.60287064389,9,1474.95623461435,83,1500,0,1438.48384209882,92,1509.99691525883,130,1419.04643539114,21,21,5,-2.32098109101822,130,52,2.49887072551287
"Copil M.",1558.52439841911,45,1555.25047740961,22,1485.21780492947,7,1466.32466111597,16,1500,0,1472.71290549235,23,1543.08942639444,42,1492.70414182017,3,3,1,0.235823089551818,42,17,2.10515284721239
"Zeng S.X.",1481.44533070837,6,1471.15747673073,6,1500,0,1500,0,1500,0,1500,0,1477.03895039312,6,1500,0,0,0,0,6,1,-0.742186771665391
"Marchenko I.",1526.01460795059,112,1541.7854119396,80,1453.12567571374,17,1432.54255364646,15,1500,0,1418.47719617367,32,1493.19268398168,89,1482.5098525121,23,23,8,0.825392154735132,89,37,0.215192163288558
"Guez D.",1420.19756919058,18,1429.630348105,14,1500,0,1474.09928917512,3,1485.22415933178,1,1468.12487619841,4,1433.25595139389,14,1464.09853159037,4,4,0,-0.661836250750939,14,2,-2.53026098162599
"Dolgopolov O.",1630.31360183743,351,1603.77164954646,214,1567.90708850824,39,1619.72049014865,98,1500,0,1642.87110351332,137,1642.15781745059,299,1542.06116050486,52,52,27,-0.207888950989125,299,156,5.42043302448634
"Serra F. ",1500,2,1500,2,1500,0,1500,0,1500,0,1500,0,1500,2,1500,0,0,0,0,2,1,0
"Seppi A. ",1500,2,1500,2,1500,0,1500,0,1500,0,1500,0,1500,2,1500,0,0,0,0,2,1,0
"Federer R. ",1537.5,5,1537.5,5,1500,0,1500,0,1500,0,1500,0,1537.5,5,1500,0,0,0,0,5,4,1.5
"Stepanek R. ",1525,4,1525,4,1500,0,1500,0,1500,0,1500,0,1525,4,1500,0,0,0,0,4,3,1
"Hernych J. ",1500,2,1500,2,1500,0,1500,0,1500,0,1500,0,1500,2,1500,0,0,0,0,2,1,0
"Chiudinelli M. ",1525,4,1525,4,1500,0,1500,0,1500,0,1500,0,1525,4,1500,0,0,0,0,4,3,1
"Korolev E. ",1512.5,3,1512.5,3,1500,0,1500,0,1500,0,1500,0,1512.5,3,1500,0,0,0,0,3,2,0.5
"Troicki V. ",1500,2,1500,2,1500,0,1500,0,1500,0,1500,0,1500,2,1500,0,0,0,0,2,1,0
"Djokovic N. ",1562.5,5,1562.5,5,1500,0,1500,0,1500,0,1500,0,1562.5,5,1500,0,0,0,0,5,5,2.5
"Nieminen J. ",1500,2,1500,2,1500,0,1500,0,1500,0,1500,0,1500,2,1500,0,0,0,0,2,1,0
"Lammer M. ",1500,2,1500,2,1500,0,1500,0,1500,0,1500,0,1500,2,1500,0,0,0,0,2,1,0
"Cilic M. ",1512.5,3,1512.5,3,1500,0,1500,0,1500,0,1500,0,1512.5,3,1500,0,0,0,0,3,2,0.5
"Gasquet R. ",1512.5,3,1512.5,3,1500,0,1500,0,1500,0,1500,0,1512.5,3,1500,0,0,0,0,3,2,0.5
"Chardy J. ",1500,2,1500,2,1500,0,1500,0,1500,0,1500,0,1500,2,1500,0,0,0,0,2,1,0
"Wawrinka S. ",1512.5,3,1512.5,3,1500,0,1500,0,1500,0,1500,0,1512.5,3,1500,0,0,0,0,3,2,0.5
"Isner J. ",1500,2,1500,2,1500,0,1500,0,1500,0,1500,0,1500,2,1500,0,0,0,0,2,1,0
"Montanes A. ",1500.44952970932,2,1500.44952970932,2,1500,0,1500,0,1500,0,1500,0,1500.44952970932,2,1500,0,0,0,0,2,1,0.0179811883727652
"Berdych T. ",1500,2,1500,2,1500,0,1500,0,1500,0,1500,0,1500,2,1500,0,0,0,0,2,1,0
"Garcia-Lopez G. ",1512.5,3,1512.5,3,1500,0,1500,0,1500,0,1500,0,1512.5,3,1500,0,0,0,0,3,2,0.5
"Davydenko N. ",1525,4,1525,4,1500,0,1500,0,1500,0,1500,0,1525,4,1500,0,0,0,0,4,3,1
"Simon G. ",1512.5,3,1512.5,3,1500,0,1500,0,1500,0,1500,0,1512.5,3,1500,0,0,0,0,3,2,0.5
"Monfils G. ",1500,2,1500,2,1500,0,1500,0,1500,0,1500,0,1500,2,1500,0,0,0,0,2,1,0
"Monaco J. ",1500,2,1500,2,1500,0,1500,0,1500,0,1500,0,1500,2,1500,0,0,0,0,2,1,0
"Ferrer D. ",1512.5,1,1512.5,1,1500,0,1500,0,1500,0,1500,0,1512.5,1,1500,0,0,0,0,1,1,0.5
"Mayer L. ",1500,2,1500,2,1500,0,1500,0,1500,0,1500,0,1500,2,1500,0,0,0,0,2,1,0
"Cuevas P. ",1500,2,1500,2,1500,0,1500,0,1500,0,1500,0,1500,2,1500,0,0,0,0,2,1,0
"Murray A. ",1562.08223466146,5,1562.08223466146,5,1500,0,1500,0,1500,0,1500,0,1562.08223466146,5,1500,0,0,0,0,5,5,2.48328938645824
"Robredo T. ",1512.5,3,1512.5,3,1500,0,1500,0,1500,0,1500,0,1512.5,3,1500,0,0,0,0,3,2,0.5
"Youzhny M. ",1537.48440875157,5,1537.48440875157,5,1500,0,1500,0,1500,0,1500,0,1537.48440875157,5,1500,0,0,0,0,5,4,1.49937635006271
"Tipsarevic J. ",1500,2,1500,2,1500,0,1500,0,1500,0,1500,0,1500,2,1500,0,0,0,0,2,1,0
"Lopez F. ",1500,2,1500,2,1500,0,1500,0,1500,0,1500,0,1500,2,1500,0,0,0,0,2,1,0
"Verdasco F. ",1524.98382687766,4,1524.98382687766,4,1500,0,1500,0,1500,0,1500,0,1524.98382687766,4,1500,0,0,0,0,4,3,0.999353075106284
"Ebden M.",1381.61338288808,113,1406.43902733109,81,1441.59480959329,20,1412.45816848492,12,1500,0,1397.52581662075,32,1370.86224888069,93,1433.68906924839,20,20,5,-1.12537602196279,93,31,-3.61008866251384
"Statham J.",1474.5972359146,5,1465.13675671109,5,1500,0,1500,0,1500,0,1500,0,1474.62709983217,5,1500,0,0,0,0,5,1,-1.01611056341619
"Sorensen L.",1489.49249239715,6,1479.92242105854,4,1500,0,1501.91654081052,2,1500,0,1504.96477799846,2,1495.12288580651,3,1485.75614960691,3,3,1,-0.260441016703405,3,1,-0.159859287410613
"Sergeyev I.",1511.17673464489,2,1508.84380275252,2,1500,0,1500,0,1500,0,1500,0,1500,0,1507.65640961457,2,2,1,0.447069385795675,0,0,0
"Brown D.",1662.56485030564,121,1529.20429219821,49,1531.60408615831,32,1545.50999756164,40,1500,0,1604.65512591131,72,1640.69309016796,99,1478.6766789918,22,22,7,0.315445596385857,99,43,6.18714841583963
"Van Der Merwe I.",1532.5003359954,10,1507.48750609261,7,1512.29195277495,3,1500,0,1500,0,1515.77079781896,3,1531.88124210011,10,1500,0,0,0,0,10,6,1.300013439816
"Souza J.",1420.44647020164,68,1450.66756664431,8,1486.85807641962,1,1430.1954423434,59,1500,0,1423.15328865823,60,1440.28716158002,61,1425.42472478852,7,7,0,-2.38147143368364,61,24,-0.800669758250751
"Jelenic P.",1499.80718244888,2,1499.14251770129,2,1500,0,1500,0,1500,0,1500,0,1499.57111726925,2,1500,0,0,0,0,2,1,-0.00771270204462415
"Sijsling I.",1441.44159644986,133,1439.85666579524,77,1488.00036838941,23,1448.20966067437,33,1500,0,1456.33348344388,56,1458.69489510438,112,1425.63806168708,21,21,5,-2.39652195739208,112,42,0.0541858153864712
"Berankis R.",1530.54549670201,132,1573.6618842096,99,1413.1415398538,13,1425.21634718153,20,1500,0,1381.1363834523,33,1530.29751629724,106,1484.22104777478,26,26,10,0.819447326431229,106,47,0.402372541649117
"Mertens Y.",1486.04455129368,3,1487.02925390001,3,1500,0,1500,0,1500,0,1500,0,1484.76912802224,3,1500,0,0,0,0,3,1,-0.558217948252902
"Matosevic M.",1519.29076278806,154,1551.50999087204,109,1482.39324768041,19,1463.09708458764,26,1500,0,1480.97810878104,45,1525.90473599768,133,1430.75709129417,21,21,3,-3.73194660185427,133,58,4.50357711337666
"El Amrani R.",1470.83041749573,7,1487.47369107424,1,1500,0,1482.72298587034,6,1500,0,1480.5954678903,6,1468.8638116612,7,1500,0,0,0,0,7,2,-1.16678330017072
"Ramos-Vinolas A.",1685.46011406131,120,1581.40606220448,47,1509.69305929097,7,1649.35410306042,66,1500,0,1656.96503496289,73,1636.48048043416,102,1565.27047642429,18,18,9,2.51534033698901,102,46,4.90306422546341
"Krajinovic F.",1460.56136621954,38,1457.82603522171,19,1493.21095536111,1,1489.06549241118,18,1500,0,1482.49711366528,19,1487.02793805323,30,1440.38371906454,8,8,1,-2.20798595816387,30,11,0.630440606945578
"Di Mauro A.",1508.68049079368,2,1500,0,1500,0,1507.65700732921,2,1500,0,1507.86958360162,2,1508.29976017711,2,1500,0,0,0,0,2,1,0.347219631747159
"Tavares L.",1491.70790853312,3,1500,0,1500,0,1491.64876344672,3,1500,0,1490.71939286993,3,1491.32588932832,3,1500,0,0,0,0,3,1,-0.331683658675262
"Munoz-De La Nava D.",1461.55328428646,27,1489.22089922074,10,1500,0,1455.24962976446,17,1500,0,1453.79253553485,17,1476.02852810185,23,1461.95213455629,4,4,0,-0.931925520223711,23,8,-0.605943108317693
"Kamke T.",1528.0829557677,158,1500.52033406759,94,1489.43361030475,21,1506.09330981083,43,1500,0,1517.03132028336,64,1539.97249945531,126,1439.77108449569,32,32,10,0.121566838835868,126,50,1.0017513918719
"Reister J.",1430.20287124599,48,1448.82335470616,5,1476.89453129701,9,1450.27601434498,32,1474.52418744771,2,1438.72948674485,43,1422.52294409137,34,1475.23456207931,14,14,5,0.600199185045319,34,9,-3.39208433520582
"Zemlja G.",1579.82645402716,64,1518.56806409083,36,1503.5623105275,13,1519.56642476611,15,1500,0,1547.34523661518,28,1542.80310882155,45,1506.4658714321,19,19,8,1.76065729923529,45,20,1.4324008618513
"Kontinen H.",1491.0073588841,3,1486.15129363282,1,1502.03258774289,2,1500,0,1500,0,1502.2774210634,2,1491.41824767399,3,1500,0,0,0,0,3,1,-0.35970564463594
"Fischer M.",1375.18127394755,21,1447.22849377387,6,1480.37396902334,4,1412.95701596342,11,1500,0,1407.20869741554,15,1384.53520813626,17,1477.43520700087,4,4,1,-0.453426155011868,17,1,-4.53932288708608
"Kudla D.",1467.88901810332,87,1432.17685212341,53,1512.45900730911,25,1465.90898405497,9,1500,0,1504.24146659125,34,1467.13660484121,66,1463.70256987081,21,21,7,0.0477032075495057,66,22,-1.33214248341654
"Bubka S.",1495.02445353983,17,1495.72946880521,13,1487.7177828518,3,1491.74977316931,1,1500,0,1481.2342430022,4,1486.22274086193,15,1508.16635548434,2,2,1,0.406037132285267,15,4,-0.605058990692052
"Skugor F.",1454.97528349268,16,1503.38568918102,3,1486.26924017447,1,1450.16295888653,11,1489.32106693485,1,1436.90245321263,13,1454.44838132247,15,1489.72624783882,1,1,0,-0.256893301653633,15,4,-1.54409535863911
"Sadecky A.",1493.33444144557,3,1500,0,1500,0,1488.90255476922,3,1500,0,1489.59127146782,3,1493.04587904946,3,1500,0,0,0,0,3,1,-0.266622342177094
"Haider-Maurer A.",1546.08284295624,98,1488.94276760214,35,1447.07938547755,13,1529.36940667383,50,1500,0,1506.51570454189,63,1532.45155770399,76,1466.18774362126,22,22,7,0.045424088555073,76,31,1.79788962969467
"Smyczek T.",1519.84647866953,98,1510.22963656835,77,1461.67641327297,11,1474.96749868309,10,1500,0,1455.59742485415,21,1501.20704934609,79,1485.19686000517,19,19,7,1.21926744381039,79,28,-0.425408297029062
"Paire B.",1571.58943455652,258,1552.93547638374,134,1468.34623713438,24,1617.6200016362,100,1500,0,1583.34210937458,124,1565.16955301186,211,1556.91494002698,47,47,23,1.46743250081575,211,98,1.39614488144493
"Ungur A.",1405.47392959031,33,1456.18933457143,5,1468.06655928338,3,1433.22674214532,25,1500,0,1414.49947956061,28,1430.43970559166,25,1448.49219062994,8,8,1,-1.19880101684252,25,5,-2.58224179954499
"Bemelmans R.",1511.52150358148,41,1514.19515317563,24,1444.17681583916,13,1477.62960040987,4,1500,0,1452.68900434752,17,1499.83620195228,30,1468.7906140055,11,11,3,0.242389407933061,30,10,0.218470735326082
"Bhambri Y.",1485.28455975036,14,1471.11528238421,14,1500,0,1500,0,1500,0,1500,0,1485.50107651637,12,1495.36963067044,2,2,0,-0.122448072009045,12,4,-0.466169537976594
"Raonic M.",1966.31374573512,358,1893.74388485818,244,1690.50366561502,41,1762.04081961033,73,1500,0,1857.43040321765,114,1925.58009438233,277,1795.79860110639,81,81,58,2.88298014330129,277,186,15.7695696861035
"Bai Y.",1498.94431498647,7,1491.10678254364,7,1500,0,1500,0,1500,0,1500,0,1495.11380755329,7,1500,0,0,0,0,7,2,-0.0422274005411555
"Donskoy E.",1455.39610384161,87,1469.52856169321,57,1477.11480230353,9,1387.14410974915,20,1487.06739389805,1,1395.0622733874,30,1432.64790081063,69,1497.97715469578,18,18,7,2.26438397191704,69,19,-4.04853981825266
"Goffin D.",1833.59612888915,224,1770.40136434119,143,1572.92725952642,27,1696.00838730759,54,1500,0,1730.43486866763,81,1806.45922044126,181,1634.27961767474,43,43,25,2.82018913695514,181,100,10.5236560186111
"Sugita Y.",1473.02955737714,40,1436.51107994675,27,1491.95372521905,10,1493.39854121816,3,1500,0,1489.89791614826,13,1472.17230640834,37,1475.79615466403,3,3,0,-0.638940263023174,37,11,-0.439877441891307
"Wolmarans F.",1490.6328165167,3,1489.56876378171,3,1500,0,1500,0,1500,0,1500,0,1491.4815120955,3,1500,0,0,0,0,3,1,-0.374687339331921
"Zampieri C.",1494.88487543523,3,1500,0,1500,0,1496.66287794974,3,1500,0,1494.39780808616,3,1496.62061107371,3,1500,0,0,0,0,3,1,-0.204604982590683
"Gonzalez S.",1454.34160694393,9,1485.67908271117,1,1486.165679625,1,1476.5229278862,7,1500,0,1462.2131509137,8,1461.68009853797,8,1487.391224953,1,1,0,-0.3298449999437,8,1,-1.49649072229892
"Kuznetsov An.",1678.14068649757,121,1615.00028950603,56,1492.76224371781,15,1540.30279618874,50,1500,0,1578.04520152463,65,1588.03383593547,90,1618.86396712917,31,31,17,6.59198598810201,90,37,0.533641471800747
"Ramos A.",1597.82317250566,147,1470.29353998389,48,1483.62484032503,5,1602.74595936975,94,1500,0,1604.21446175141,99,1609.93750065722,133,1436.06763152597,14,14,2,-2.54375054847936,133,65,6.45667744870573
"Teixeira M.",1473.75780743255,6,1480.80098764256,2,1500,0,1487.60710184762,4,1500,0,1492.14472208618,4,1475.61371947614,3,1498.74917538714,3,3,1,-0.0321073716231288,3,0,-1.01758033107497
"Schoorel T.",1486.54980746333,6,1471.29383813106,4,1500,0,1508.60350197079,2,1500,0,1508.06935931646,2,1474.13395596989,4,1506.13571240242,2,2,1,0.434601092723372,4,0,-0.972608794190358
"Marti J.",1452.07253434212,13,1493.36944092554,2,1497.1089078085,2,1444.54750148309,9,1500,0,1446.63188436911,11,1459.03604320439,12,1487.5,1,1,0,-0.480739284986283,12,2,-1.43635934132884
"Wang J.",1511.29330232856,21,1491.41619904223,7,1496.43061829138,10,1499.30571661101,4,1500,0,1510.49244023012,14,1480.55791198627,11,1514.23634322817,10,10,4,1.5074176031762,11,4,-1.05568551003385
"Yani M.",1447.59548910914,17,1437.41890237705,9,1521.19290776842,5,1462.72072764525,3,1500,0,1486.18317124579,8,1473.21428370849,13,1452.61108982325,4,4,0,-1.48860226174309,13,4,-0.607578173891415
"Dasnieres de Veigy J.",1474.40192655678,6,1484.11665419035,2,1500,0,1485.39214348353,4,1500,0,1484.95568128807,4,1488.693758681,4,1487.22416156202,2,2,0,-0.539877060893553,4,1,-0.484045876835064
"Olaso G.",1492.08681161794,6,1485.80656568479,1,1500,0,1498.51959005724,5,1500,0,1499.25893020885,5,1490.54624835508,6,1500,0,0,0,0,6,2,-0.316527535282429
"Stebe C.M.",1525.02438640984,34,1462.12482437611,11,1486.29117100634,7,1550.51419507599,16,1500,0,1549.16301224349,23,1524.29880072419,26,1482.55983446324,8,8,2,-0.506768074656615,26,10,1.5077435310502
"Cervenak P.",1532.04435687775,9,1500,0,1500,0,1529.33077879381,8,1486.37695199545,1,1527.13406106765,9,1530.28796064158,9,1500,0,0,0,0,9,5,1.2817742751098
"Del Bonis F.",1529.37848426426,13,1486.06311764957,1,1500,0,1540.73454070419,12,1500,0,1537.70651506076,12,1530.44893570926,13,1500,0,0,0,0,13,6,1.1751393705702
"Ito T.",1519.2933162385,76,1463.94276498995,49,1497.20774813583,18,1481.86556566655,9,1500,0,1498.95427345257,27,1519.61212661279,62,1434.66316600881,14,14,3,-0.900889831474339,62,24,1.67262248101453
"Knittel B.",1490.15287128101,5,1500,0,1486.18183332395,1,1489.45524086738,4,1500,0,1485.9378233317,5,1495.72195065324,4,1487.82813655727,1,1,0,-0.215474544175719,4,1,-0.178410604583792
"Kosakowski D.",1492.39340387681,3,1491.60978584857,3,1500,0,1500,0,1500,0,1500,0,1493.12237817083,3,1500,0,0,0,0,3,1,-0.304263844927556
"Pospisil V.",1598.83613509066,173,1620.49145295754,128,1483.68378726218,27,1412.798905813,18,1500,0,1452.23425945057,45,1594.12130487945,145,1489.39289851567,28,28,11,-2.3354696489882,145,65,6.28891505261464
"Duclos P.L.",1496.65796048411,4,1491.60400111502,3,1491.59441740376,1,1500,0,1500,0,1498.4229952717,1,1493.018364885,4,1500,0,0,0,0,4,1,-0.133681580635763
"Jaziri M.",1577.99107113339,105,1530.39957835285,69,1461.81278973243,18,1515.0715206565,18,1500,0,1498.20201586997,36,1579.46601744991,86,1457.17547386132,19,19,6,0.0162569752502771,86,35,3.10338587008525
"Dutra Da Silva R.",1503.14742514554,2,1501.76400305262,2,1500,0,1500,0,1500,0,1500,0,1500,0,1499.30193522031,2,2,1,0.125897005821452,0,0,0
"Sock J.",1841.00656848569,191,1783.59357401663,135,1562.64731710363,18,1650.56602169004,38,1500,0,1689.30655280317,56,1816.30849658564,153,1603.14472493416,38,38,22,2.42205185775922,153,90,11.2182108816683
"Giannessi A.",1483.54002494942,11,1508.30898341414,2,1500,0,1476.28188697133,9,1500,0,1472.99462936123,9,1475.26604862482,9,1509.27963329733,2,2,1,0.452182330179327,9,3,-1.11058133220252
"Rodrigues M.",1511.65235221092,2,1510.8424258553,2,1500,0,1500,0,1500,0,1500,0,1510.05101388419,2,1500,0,0,0,0,2,1,0.466094088436823
"Renavand N.",1509.10622040934,2,1505.28298455563,2,1500,0,1500,0,1500,0,1500,0,1507.51747810786,2,1500,0,0,0,0,2,1,0.364248816373583
"Zhang Z.",1492.05557479018,15,1473.36161265752,13,1501.09290565611,2,1500,0,1500,0,1504.24170327705,2,1500.26246457949,13,1487.37450715517,2,2,0,-0.503815413664571,13,4,0.18603840527169
"Rieschick S.",1475.35171441342,4,1499.63991702395,2,1500,0,1472.82534212367,2,1500,0,1472.02548556118,2,1474.52500866837,4,1500,0,0,0,0,4,1,-0.985931423463132
"Lajovic D.",1597.84576760443,122,1517.16410311601,48,1457.1526582966,7,1580.71535150186,67,1500,0,1564.03233573744,74,1595.48867056796,103,1497.78668675551,19,19,8,1.51514525934857,103,43,2.39868544482865
"Bedene A.",1556.61588910933,117,1554.01006751171,57,1488.5294502343,14,1489.25579560599,46,1500,0,1501.24798065835,60,1541.51234135588,99,1455.33835318381,18,18,4,-1.61054204348991,99,45,3.87517760786306
"Thiem D.",1823.65094252404,199,1699.37770857272,100,1553.67270175593,17,1836.2646141199,82,1500,0,1839.92763751802,99,1793.25068970034,167,1634.69105996403,32,32,20,2.54590708338526,167,100,10.4001306175762
"Duckworth J.",1505.62119491892,55,1503.39464017956,40,1480.56544604052,7,1479.38346402965,8,1500,0,1466.52897735524,15,1519.84012445224,36,1447.17354462232,19,19,5,-2.02726501044466,36,14,2.25211280720135
"Dutra Silva R.",1425.78530909972,32,1511.36936798742,6,1463.4045135374,3,1417.83051545824,23,1500,0,1402.65929304449,26,1422.73856780549,22,1474.14070843158,10,10,2,0.188044392914571,22,5,-3.15663202892582
"Kutrovsky D.",1514.30343167165,3,1513.77632859852,3,1500,0,1500,0,1500,0,1500,0,1514.02991333912,3,1500,0,0,0,0,3,2,0.572137266865895
"Bagnis F.",1478.89707065803,33,1486.93533734204,2,1477.61793876833,2,1493.5896383728,29,1500,0,1476.80969358944,31,1483.55289116033,25,1473.42174678886,8,8,2,-0.330423578782023,25,9,-0.513693594896841
"Olivetti A.",1486.97192775153,14,1516.71852419895,11,1474.93619101084,2,1488.45977863279,1,1500,0,1464.16300988575,3,1517.61490948502,11,1461.453199723,3,3,0,-1.47163039860346,11,5,0.950507508664771
"Bautista R.",1852.80813512962,220,1804.35060887991,145,1602.19962486876,19,1666.20627991839,56,1500,0,1697.41886389629,75,1809.28943572535,181,1675.69607655636,39,39,25,4.26690013122083,181,107,9.8454252739641
"Gutierrez-Ferrol S.",1499.32267238281,4,1500,0,1500,0,1502.93275650894,4,1500,0,1502.04261924848,4,1499.83409909745,4,1500,0,0,0,0,4,2,-0.0270931046876103
"Delbonis F.",1593.12898208537,156,1476.86332475109,53,1446.52615304452,5,1654.14671944489,98,1500,0,1638.46058334403,103,1598.17961094009,138,1454.04412297474,18,18,5,-3.14796094720188,138,69,6.87312023061652
"Farah R.",1499.87338875961,9,1464.62221644138,3,1500,0,1528.3343901801,6,1500,0,1527.7691483301,6,1507.59907323737,8,1483.75234988419,1,1,0,-0.377250997681898,8,3,0.372186548066144
"Zopp J.",1459.93578886228,34,1477.88555991302,17,1462.73820778746,3,1474.26099111059,14,1500,0,1457.53038098956,17,1463.61335916872,23,1458.97388855859,11,11,2,-0.718239300384771,23,8,-0.884329145123866
"Balazs A.",1523.6066718858,7,1500,0,1500,0,1518.51346117594,7,1500,0,1522.61663703066,7,1522.35670407262,7,1500,0,0,0,0,7,4,0.944266875431919
"Cervantes I.",1488.5422026409,48,1486.94551099456,13,1484.4451363358,4,1478.26514274722,31,1500,0,1468.14478813108,35,1487.11269202265,42,1473.71425367716,6,6,1,-0.391519453989822,42,16,-0.0667924403742993
"Pavic M.",1473.18331143345,11,1488.47345865561,1,1487.78708693211,5,1482.86999086551,5,1500,0,1471.95387060883,10,1471.84754583001,11,1500,0,0,0,0,11,3,-1.07266754266213
"Janowicz J.",1623.66482325416,152,1613.90022632486,96,1558.05970568265,20,1506.9214954185,36,1500,0,1561.57064553745,56,1627.69208638311,115,1581.24302893995,37,37,21,3.17509761477826,115,53,1.77149531538832
"De Schepper K.",1406.94963536581,76,1426.73489024744,32,1482.94109503567,20,1404.34223054783,24,1500,0,1415.99464694078,44,1400.18205178731,57,1463.15243487787,19,19,6,0.818344237001628,57,15,-4.54035882236911
"Trungelliti M.",1501.09662240193,10,1497.90614606204,3,1500,0,1498.23530467241,7,1500,0,1499.72173943713,7,1478.08035006453,6,1512.30813488497,4,4,2,0.848300367778931,6,2,-0.804435471701637
"Johnson S.",1708.60758996849,181,1657.06033011268,126,1601.10013624806,31,1483.61693270008,24,1500,0,1614.50518541944,55,1681.40973046018,149,1543.72148810732,32,32,14,0.370435841486164,149,75,7.97386775725332
"Oswald P.",1482.03283864629,4,1490.72764473282,1,1500,0,1489.12161243098,3,1500,0,1489.58242256108,3,1481.26138682199,4,1500,0,0,0,0,4,1,-0.718686454148405
"Mcclune M.",1506.30193217748,2,1504.30251318307,2,1500,0,1500,0,1500,0,1500,0,1503.84632977987,2,1500,0,0,0,0,2,1,0.252077287099379
"Novikov D.",1479.70557537957,11,1479.16746789005,7,1473.99504426189,4,1500,0,1500,0,1481.5831163774,4,1468.42115390734,7,1503.81925140213,4,4,2,0.471020250230856,7,1,-1.28279723504825
"Klahn B.",1437.65856377202,22,1457.76736677329,17,1472.38882727393,3,1475.44952970932,2,1500,0,1448.880465608,5,1447.07698911137,13,1458.72516101102,9,9,2,-0.44218494513677,13,2,-2.05147250398227
"Reix C.",1510.30656665679,2,1508.37274601949,2,1500,0,1500,0,1500,0,1500,0,1509.98237603748,2,1500,0,0,0,0,2,1,0.412262666271784
"Millot V.",1467.18234014891,21,1471.35873660868,17,1486.52425134741,1,1466.75359584915,3,1500,0,1454.67358942442,4,1467.76137549773,16,1476.99455841977,5,5,1,-0.261402634618156,16,4,-1.05130375942538
"Moriya H.",1479.82277403152,11,1474.8384068351,10,1493.66674353965,1,1500,0,1500,0,1494.80848620376,1,1496.88461305921,8,1474.67902108263,3,3,0,-0.812613185450559,8,2,0.00552414671119994
"Rosenholm P.",1508.33445692401,3,1505.12783191448,3,1500,0,1500,0,1500,0,1500,0,1506.6141117779,3,1500,0,0,0,0,3,1,0.333378276960419
"Millman J.",1605.14298114459,61,1539.57057556672,49,1528.03982861723,9,1467.76491309845,3,1500,0,1527.93968369943,12,1576.56965922921,48,1507.73410346232,13,13,5,1.11646111613709,48,20,3.08925812964654
"Stebe C-M.",1511.60731811387,2,1510.20174312933,2,1500,0,1500,0,1500,0,1500,0,1511.02819668148,2,1500,0,0,0,0,2,1,0.464292724554998
"Safwat M.",1491.78298379856,3,1490.40309817501,3,1500,0,1500,0,1500,0,1500,0,1491.29371568559,3,1500,0,0,0,0,3,1,-0.328680648057622
"Jones G.",1470.20651019772,7,1473.09948678624,6,1490.1464389343,1,1500,0,1500,0,1489.157888122,1,1474.08720378497,6,1491.08114332233,1,1,0,-0.178685294555681,6,1,-1.01305429753533
"Weintraub A.",1470.4179271311,5,1477.11027852356,4,1487.05655978978,1,1500,0,1500,0,1486.96005674625,1,1464.89381785627,3,1504.50085994082,2,2,1,0.30270403692827,3,0,-1.4859869516844
"Brugues-Davi A.",1490.76398501795,4,1501.55776308756,3,1500,0,1487.22231632001,1,1500,0,1487.28108236692,1,1495.89892425485,3,1492.04947009144,1,1,0,-0.256572694731563,3,1,-0.112867904550419
"Garin C.",1476.04124370058,5,1500,0,1500,0,1472.45642523443,5,1500,0,1473.2143890214,5,1472.90881143021,5,1500,0,0,0,0,5,1,-0.958350251976667
"Viola M.",1491.16292719551,13,1502.24797027235,6,1488.50602268253,1,1478.60966024183,6,1500,0,1469.6112125242,7,1487.11623231743,13,1500,0,0,0,0,13,4,-0.353482912179597
"Alund M.",1532.70657351688,17,1500,0,1493.39962565473,1,1533.5439988819,16,1500,0,1531.40259683434,17,1540.91637316879,15,1483.99270529869,2,2,0,-0.455506174929293,15,7,1.76376911560452
"Pella G.",1534.134693483,68,1493.94699298997,26,1462.47980343969,4,1538.52885815367,38,1500,0,1516.63283107983,42,1519.65451806333,54,1487.03331749645,14,14,4,-0.380564179160006,54,21,1.74595191847985
"Schwartzman D.",1629.3764731133,77,1573.82221727631,28,1452.52498144162,4,1552.28409474104,45,1500,0,1522.8711519385,49,1637.40075252994,64,1467.23556246617,13,13,3,-0.739723327495353,64,28,5.91478225202739
"Williams R.",1462.23826590075,25,1464.43645358897,17,1480.42535663662,2,1501.92804615759,6,1500,0,1482.9068208282,8,1482.22947683634,20,1462.53758298853,5,5,0,-1.37162922276207,20,7,-0.138840141207848
"Laaksonen H.",1450.62788894412,20,1461.87965955603,7,1500,0,1467.90443000166,13,1500,0,1468.65732427703,13,1444.74360391622,20,1500,0,0,0,0,20,5,-1.97488444223503
"Carreno-Busta P.",1559.98748493313,107,1471.74075632227,40,1473.22233273004,3,1567.70116450615,64,1500,0,1557.54696176569,67,1544.96357545825,93,1493.48378071568,14,14,4,0.349410685922369,93,37,2.05008871140263
"Elias G.",1531.48030661515,43,1481.09523698861,9,1474.9810746238,2,1557.26528522516,32,1500,0,1542.2488865594,34,1558.69740844106,38,1444.00314500547,5,5,0,-2.13320866109538,38,16,3.39242092570147
"Kyrgios N.",1854.49590936716,113,1773.75765963121,68,1592.36692921612,15,1652.21952709533,30,1500,0,1723.15731760735,45,1809.58512648376,74,1676.74892928243,39,39,25,8.11667586643311,74,46,6.0631605082534
"Pouille L.",1785.95828180713,90,1677.63168807821,53,1513.38139006161,9,1627.84478062108,28,1500,0,1650.36181302447,37,1723.49519370879,69,1569.04074535815,21,21,10,1.29313485155151,69,37,10.1451964207336
"Basic M.",1516.94588821185,11,1514.04647290389,6,1499.31476593233,2,1489.47715861337,3,1500,0,1492.86392913049,5,1502.43870337214,9,1509.32429763906,2,2,1,0.581641546753052,9,4,0.0961939817208264
"Evans D.",1598.43198764401,39,1557.60394505328,21,1483.93671163094,18,1500,0,1500,0,1514.07600608675,18,1544.30138412665,26,1536.26150921324,13,13,6,2.48155844625476,26,11,1.45572105950549
"Edmund K.",1625.7080576327,50,1589.38954127241,29,1449.8644581509,13,1515.27464029859,8,1500,0,1491.50452361384,21,1583.24554967162,37,1508.96804799117,13,13,5,1.16078137878632,37,15,3.86754092652177
"Struff J.L.",1548.97651303019,94,1569.23973316602,47,1437.21515257086,14,1444.5498263693,33,1500,0,1422.57487976946,47,1559.45569122594,78,1427.33653527624,16,16,3,-2.60149688360396,78,31,4.56055740481175
"Kuznetsov Al.",1431.58183445017,21,1458.51340621889,12,1450.90989911672,6,1484.69655564827,3,1500,0,1449.04864604764,9,1441.03018865696,18,1466.02480589517,3,3,0,-0.952440055305493,18,5,-1.78428656668757
"Langer N.",1498.55535434121,3,1488.87840289261,1,1500,0,1505.79886670728,2,1500,0,1506.36195099679,2,1498.2637541584,3,1500,0,0,0,0,3,1,-0.0577858263517163
"Estrella Burgos V.",1543.2424250246,81,1433.39109172515,29,1474.25613893884,13,1600.44420636058,39,1500,0,1586.49950474813,52,1558.7901168353,66,1454.27015484497,15,15,4,-2.23896566392011,66,32,3.96866266490421
"Gomez E.",1502.53681967141,3,1489.53437016863,1,1500,0,1504.38505223243,2,1500,0,1504.84262981855,2,1500.61693745996,3,1500,0,0,0,0,3,1,0.101472786856438
"Harrison C.",1500.40897771233,3,1497.24812551024,3,1500,0,1500,0,1500,0,1500,0,1509.29999077675,2,1488.35208822611,1,1,0,-0.370882039555102,2,1,0.387241148048418
"Peliwo F.",1490.35098935221,6,1490.04962368566,4,1500,0,1505.25563835092,2,1500,0,1504.83944919172,2,1490.43922203963,6,1500,0,0,0,0,6,2,-0.385960425911649
"Gojowczyk P.",1534.29858596291,26,1538.29342799393,18,1496.92458747229,4,1457.05813023297,4,1500,0,1465.7315337992,8,1541.83862302505,18,1468.22433402313,8,8,2,-0.782542095572667,18,8,2.1544855340889
"Fucsovics M.",1475.89028945838,8,1495.2526715459,3,1487.02623821531,1,1484.7884855898,4,1500,0,1474.98192171311,5,1478.79556819044,7,1492.52986196436,1,1,0,-0.271793495693499,7,2,-0.692594925971171
"Khachanov K.",1615.06473941331,29,1570.20235607079,20,1500,0,1518.300121861,9,1500,0,1519.12260662987,9,1599.21970103598,27,1507.72677891313,2,2,1,0.359892643479802,27,15,4.24269693305267
"Mecir M.",1488.84128887225,4,1493.64429535492,3,1500,0,1486.57682195013,1,1500,0,1487.21095195756,1,1499.85994437503,3,1486.73336746368,1,1,0,-0.495699571735847,3,1,0.0493511266258898
"Pospisil J.",1461.73207042128,8,1496.03599606854,3,1479.76849549584,2,1467.66079502044,3,1500,0,1452.72747851771,5,1468.04820967579,7,1489.28997060637,1,1,0,-0.316858637752184,7,1,-1.21385854539677
"Herbert P.H.",1519.7299527506,34,1486.60982551472,22,1515.4540395079,9,1473.6595919304,3,1500,0,1507.24340408603,12,1485.25578549799,22,1496.81295598496,12,12,5,1.06975306964043,22,7,-0.280554959616536
"Vesely J.",1664.90460832093,128,1543.88451084526,59,1532.76774677171,16,1587.37994832805,53,1500,0,1621.39499837681,69,1625.59382544891,105,1522.73428712046,23,23,10,0.927501192751206,105,48,5.66868314008602
"Ramanathan R.",1491.62660070606,8,1485.01014336016,8,1500,0,1500,0,1500,0,1500,0,1490.52864598379,8,1500,0,0,0,0,8,3,-0.334935971757491
"Dzumhur D.",1596.44920146182,63,1547.49432446943,33,1501.71873761323,5,1559.3968956068,25,1500,0,1558.67139890234,30,1580.76342547399,46,1519.13898402854,17,17,7,1.31084098163379,46,22,2.54712707683907
"Rola B.",1492.48760934275,25,1478.49839500809,9,1464.8993432815,5,1512.14016605026,11,1500,0,1491.51400616184,16,1502.74414742646,18,1476.9724810772,7,7,2,-0.432418210137578,18,7,0.131922583847394
"Kokkinakis T.",1546.37217398023,36,1497.79180599122,28,1492.20633035102,3,1503.77079595384,5,1500,0,1512.17191021268,8,1509.67360325214,27,1525.18304219046,9,9,4,1.60947400775422,27,9,0.245412951454852
"Daniel T.",1462.43670631425,33,1458.69182168734,11,1486.69121095624,1,1480.68689043607,21,1500,0,1477.57710575507,22,1457.86839805562,27,1475.83314484413,6,6,1,0.00204236798600077,27,8,-1.50457411541599
"Gonzalez A.",1422.41663324412,46,1466.34713135947,21,1474.82836306867,2,1422.74057450263,23,1500,0,1413.96396158986,25,1409.1961425231,37,1483.44538494947,9,9,3,0.339906466085906,37,9,-3.44324113632114
"Carballes Baena R.",1499.09218978677,25,1489.68450037395,1,1500,0,1496.32640520629,24,1500,0,1493.82687200355,24,1504.68155849302,24,1487.5,1,1,0,-0.509323442365065,24,10,0.473011033836028
"Nedovyesov A.",1421.9594837513,23,1458.15906554905,11,1468.09662253098,3,1457.21804316108,9,1500,0,1432.23222848488,12,1415.30403103465,15,1484.78280665863,8,8,2,0.288896796661908,15,2,-3.41051744661
"Milojevic N.",1505.43565896401,2,1500,0,1500,0,1501.25338552474,2,1500,0,1503.16944143213,2,1505.18111077954,2,1500,0,0,0,0,2,1,0.21742635856032
"Delic M.",1461.68804829252,10,1486.66474400285,2,1500,0,1465.76663635592,8,1500,0,1466.00256315593,8,1460.55026760179,10,1500,0,0,0,0,10,2,-1.53247806829903
"Kubler J.",1501.59585908939,3,1494.87463890473,1,1500,0,1499.82695631195,2,1500,0,1501.26510847513,2,1504.64970405882,2,1489.4448604008,1,1,0,-0.175264704355076,2,1,0.239099067930701
"Michon A.",1506.66719108959,2,1500,0,1500,0,1503.59380540328,2,1500,0,1504.10260508534,2,1500,0,1503.32083236828,2,2,1,0.266687643583544,0,0,0
"Saville L.",1475.69836819033,8,1475.90070976994,2,1485.99818807397,6,1500,0,1500,0,1493.03439948708,6,1502.06736468245,2,1460.48732771887,6,6,1,-1.01265339861842,2,1,0.0405881262316434
"Puetz T.",1500.37781474536,3,1488.66115373322,1,1499.51337809897,2,1500,0,1500,0,1508.65504111777,2,1500,0,1488.26927620713,3,3,1,0.0151125898142287,0,0,0
"Pavic A.",1467.16175721392,13,1474.50907495346,5,1489.05748358891,6,1482.75519231884,2,1500,0,1473.27797959355,8,1460.57785900835,10,1499.17543822957,3,3,1,0.271930397835152,10,2,-1.58546010927849
"Lindell C.",1450.51803315439,10,1486.2551300277,1,1500,0,1460.60710916475,9,1500,0,1459.52285877361,9,1454.71583233806,9,1497.05439046637,1,1,0,-0.0959699624087021,9,2,-1.88330871141553
"Albot R.",1451.09735197556,23,1444.57002171754,13,1502.83059958493,2,1478.37513247086,8,1500,0,1480.44668789163,10,1452.83304657459,17,1480.14068531234,6,6,1,-0.44900747523147,17,4,-1.50709844574606
"Ymer E.",1449.0876221467,24,1436.17514332475,8,1492.65009746187,1,1486.0218231684,15,1500,0,1481.63697189208,16,1472.80312683338,20,1450.86303319905,4,4,0,-1.61942369510912,20,6,-0.417071419023053
"Olivo R.",1561.89798338657,23,1487.83642194727,3,1500,0,1558.95668036799,20,1500,0,1558.24259125085,20,1557.00244800838,21,1497.85174707067,2,2,1,0.135499380858273,21,11,2.34041995460461
"Krajicek A.",1501.46991753326,35,1513.88189290957,28,1478.84516026422,4,1463.82190681167,3,1500,0,1446.08960876976,7,1484.2132478489,30,1497.65552198794,5,5,2,0.479778111192445,30,10,-0.420981409862251
"Marti Y.",1477.28248016254,7,1500,0,1500,0,1477.218994326,7,1500,0,1474.82681605899,7,1475.52441249135,7,1500,0,0,0,0,7,2,-0.908700793498228
"Davydenko P.",1495.91569826065,3,1489.66173912416,1,1500,0,1505.12463738761,2,1500,0,1505.26530857828,2,1495.33090012982,3,1500,0,0,0,0,3,1,-0.163372069573871
"Zverev A.",1812.82550094911,108,1721.91601942871,54,1589.19097064789,17,1631.34229374753,37,1500,0,1686.88481825701,54,1796.82862605663,96,1530.31499078979,12,12,6,-0.539127679137185,96,56,13.0521477171016
"Coric B.",1684.13542220958,103,1633.67683218325,61,1481.38534896404,7,1584.26101223459,35,1500,0,1572.70677287353,42,1681.97426298689,88,1501.9999377808,15,15,6,-0.418486583398488,88,44,7.78390347178174
"Kohlschreiber P..",1502.37863584377,2,1500.2823747151,2,1500,0,1500,0,1500,0,1500,0,1502.53674575132,2,1500,0,0,0,0,2,1,0.0951454337507887
"Wang C.",1508.52738166192,2,1505.94372789731,2,1500,0,1500,0,1500,0,1500,0,1508.00012895252,2,1500,0,0,0,0,2,1,0.341095266476617
"Basilashvili N.",1516.35870884095,27,1485.52844835543,15,1520.9704474366,3,1499.9687755831,9,1500,0,1516.79179138341,12,1515.48002009203,20,1486.50420070947,7,7,2,-0.0777779406167162,20,8,0.732126294254795
"Venus M.",1454.98283275685,8,1455.64489265249,7,1500,0,1486.94353362769,1,1500,0,1487.48545327833,1,1451.10258359435,8,1500,0,0,0,0,8,1,-1.80068668972611
"Melzer G.",1467.95792687936,22,1453.92626707279,5,1500,0,1494.39747234386,17,1500,0,1490.6297640851,17,1475.03345008228,21,1485.16262047991,1,1,0,-0.384688166288867,21,6,-0.896994758536541
"Jarry N.",1479.63925352625,5,1477.29920990433,2,1500,0,1498.80039175175,3,1500,0,1498.22174924664,3,1477.7254026204,5,1500,0,0,0,0,5,1,-0.814429858949842
"Donaldson J.",1542.59751932976,30,1528.12646068466,26,1476.11408099482,4,1500,0,1500,0,1478.33390963086,4,1510.19813854634,25,1507.37276985914,5,5,2,0.890894524584868,25,9,0.813006248605346
"Vanni L.",1447.16479071697,19,1452.50292925309,7,1484.59788940827,1,1484.07351282475,11,1500,0,1474.29061316991,12,1460.21027344054,17,1478.07702688218,2,2,0,-0.868444954384943,17,5,-1.24496341693624
"Rublev A.",1489.30945833067,25,1494.68550560729,15,1500,0,1471.8620859696,10,1500,0,1474.30682267594,10,1481.82104516201,24,1494.19900317979,1,1,0,-0.126718579403922,24,8,-0.300903087369107
"Nishioka Y.",1515.24435975751,29,1509.82649803523,26,1475.72678673903,2,1496.90358301032,1,1500,0,1473.05811760352,3,1530.43504913969,22,1453.7526018055,7,7,1,-1.07014994753983,22,10,1.6799243378402
"Arguello F.",1397.86766685424,16,1500,0,1491.64446328853,1,1395.97952622457,15,1500,0,1394.14353187011,16,1403.99163199583,14,1488.05114069441,2,2,0,-0.227193233150883,14,1,-3.85810009267943
"Andreozzi G.",1499.71251227881,4,1490.87131482297,2,1500,0,1507.08698748552,2,1500,0,1507.01914187372,2,1507.44449612168,2,1487.88078771796,2,2,0,-0.300470055546267,2,1,0.288970546698665
"Chung H.",1525.17038561831,38,1521.70766742299,25,1486.82562338887,3,1492.1166006333,10,1500,0,1485.55994428688,13,1525.37781702487,33,1483.54372744033,5,5,1,-0.710978440694266,33,14,1.71779386542664
"De Greef A.",1501.96862331267,2,1500,0,1500,0,1498.65042863706,2,1500,0,1497.82626765143,2,1502.34293939442,2,1500,0,0,0,0,2,1,0.0787449325069455
"Mektic N.",1469.38476112877,8,1477.77141905975,2,1500,0,1495.60751559227,5,1486.49439081908,1,1486.11571251822,6,1469.79763192617,8,1500,0,0,0,0,8,2,-1.2246095548491
"Donati M.",1515.03284080652,2,1500,0,1500,0,1513.61804085039,2,1500,0,1514.07507254986,2,1514.53522054436,2,1500,0,0,0,0,2,1,0.601313632260807
"Mina G.",1486.99646875759,5,1500,0,1500,0,1477.47686753139,5,1500,0,1479.69079182389,5,1485.52364450145,4,1498.26468816021,1,1,0,-0.0278364340790228,4,1,-0.492304815617257
"Arnaboldi A.",1491.52403808826,10,1500,0,1500,0,1471.97440861419,10,1500,0,1477.01169627245,10,1485.3253701271,7,1495.46284200847,3,3,1,0.0136155694552222,7,2,-0.352654045924871
"Fritz T.",1531.13369666504,39,1518.98301571018,29,1484.07750865344,7,1494.51889168781,3,1500,0,1486.06672613598,10,1535.55211855181,35,1466.34727989997,4,4,0,-0.807388382606836,35,16,2.05273624920843
"Broady L.",1487.94262401459,5,1500,0,1470.90140158213,5,1500,0,1500,0,1477.59694293065,5,1477.49790560007,2,1497.92431327258,3,3,1,0.337449433178971,2,0,-0.819744472595336
"Smith J.P.",1464.67131894238,17,1442.51300151125,10,1512.42795119062,7,1500,0,1500,0,1510.76775379492,7,1489.7407493993,14,1467.209719721,3,3,0,-1.4348677541218,14,5,0.0217205118169752
"Demoliner M.",1499.70129960832,2,1500,0,1500,0,1496.90649229336,2,1500,0,1496.63131144604,2,1499.85565502,2,1500,0,0,0,0,2,1,-0.011948015667383
"Sarkissian A.",1499.06284626181,5,1494.68022080762,3,1500,0,1498.42950698519,2,1500,0,1498.3890319994,2,1498.02290911936,5,1500,0,0,0,0,5,2,-0.0374861495274703
"Menendez-Maceiras A.",1451.72804702032,8,1468.7260653532,3,1472.07183640525,2,1486.33057728987,3,1500,0,1462.78544793094,5,1462.51642141087,6,1473.07993300506,2,2,0,-0.697878771178038,6,1,-1.23299934800925
"Galan D.E.",1504.4915452843,2,1500,0,1500,0,1501.0661308479,2,1500,0,1504.16408268626,2,1504.39314009244,2,1500,0,0,0,0,2,1,0.179661811372131
"Gomez A.",1504.85780927507,2,1500,0,1500,0,1497.96389654095,2,1500,0,1502.32451909438,2,1504.06269431257,2,1500,0,0,0,0,2,1,0.194312371002942
"Trinker B.",1505.18575159923,3,1500,0,1500,0,1506.30949830185,3,1500,0,1505.82992312745,3,1505.28242830687,3,1500,0,0,0,0,3,1,0.207430063969176
"Munar J.",1492.19424728971,4,1500,0,1500,0,1486.48764143023,4,1500,0,1486.03758261102,4,1490.22977318815,4,1500,0,0,0,0,4,1,-0.312230108411655
"Novak D.",1477.31700918136,5,1491.00404769568,1,1500,0,1483.30542977846,4,1500,0,1482.59475817412,4,1479.36408001378,5,1500,0,0,0,0,5,1,-0.907319632745553
"Herbert P.H",1574.02035363498,16,1551.02971107181,14,1500,0,1512.61344885592,2,1500,0,1513.06903683523,2,1571.90214198052,15,1491.6735489137,1,1,0,-0.264641556251798,15,8,3.22545570165101
"Tiafoe F.",1438.6514406892,14,1450.05861388365,11,1500,0,1468.13774918134,3,1500,0,1468.24731022763,3,1447.96573023912,11,1475.92687484027,3,3,0,-0.552622815209546,11,2,-1.90131955722263
"Zhang Zh.",1502.95036309455,2,1500.83085064272,2,1500,0,1500,0,1500,0,1500,0,1502.16079574613,2,1500,0,0,0,0,2,1,0.11801452378184
"Zhang Ze",1476.23365576545,7,1469.987529069,7,1500,0,1500,0,1500,0,1500,0,1474.07167435188,7,1500,0,0,0,0,7,1,-0.950653769382128
"Karatsev A.",1462.73665911172,7,1457.23071781139,7,1500,0,1500,0,1500,0,1500,0,1459.65819922864,7,1500,0,0,0,0,7,1,-1.49053363553121
"Fabbiano T.",1467.2120419607,20,1500.71823036647,11,1500,0,1434.25080075698,9,1500,0,1437.53893952086,9,1479.61559760636,17,1472.94149751141,3,3,0,-0.774992042727861,17,5,-0.536526278843959
"Barton M.",1530.8678513108,6,1516.48622443774,2,1503.29106746134,2,1503.07897215403,2,1500,0,1508.15151149144,4,1523.3059697267,4,1505.69443667406,2,2,1,0.277375657974053,4,2,0.957338394457786
"Thompson J.",1460.45719650593,14,1469.98850175053,9,1466.81585788869,3,1501.55175564662,2,1500,0,1472.10958036186,5,1491.40753393983,7,1449.15727906476,7,7,1,-1.42807771117973,7,2,-0.153634428582907
"Rubin N.",1466.33843299088,9,1464.20864187264,8,1486.58123927977,1,1500,0,1500,0,1486.04554586258,1,1461.96197820336,6,1489.72099829811,3,3,1,0.02170219122664,6,1,-1.36816487159149
"Halys Q.",1492.01197962909,11,1494.39243138287,6,1500,0,1487.59738181857,5,1500,0,1487.14080163537,5,1466.79266271649,6,1509.000200827,5,5,2,0.962206320364445,6,1,-1.28172713520082
"Jasika O.",1498.20013705768,3,1495.8321147582,3,1500,0,1500,0,1500,0,1500,0,1484.94509985051,1,1508.30939818764,2,2,1,0.502084334017017,1,0,-0.5740788517097
"Monteiro T.",1536.62102921547,12,1474.9653169071,2,1500,0,1557.98143005563,10,1500,0,1559.57381331557,10,1534.57398980386,12,1500,0,0,0,0,12,6,1.46484116861867
"Fratangelo B.",1505.93201664875,17,1487.41896960505,14,1491.35842876223,1,1510.60650902435,2,1500,0,1507.52420377925,3,1515.78650010884,11,1472.99224181478,6,6,1,-0.594024643975838,11,5,0.831305309925668
"Kovalik J.",1472.01394343568,11,1478.51294190806,7,1500,0,1482.77085825132,4,1500,0,1482.79829088011,4,1491.00944110903,9,1474.83711321596,2,2,0,-0.85560730359766,9,3,-0.263834958975019
"Paul T.",1466.99722186131,6,1460.13187573636,4,1500,0,1501.54590572973,2,1500,0,1500.54850854562,2,1470.55687768983,5,1491.90797385954,1,1,0,-0.232490174870013,5,1,-1.08762095067742
"Carreno Busta P.",1750.36067004607,51,1677.83176137645,27,1484.06727698682,2,1609.46338471427,22,1500,0,1598.46219737092,24,1729.75262094641,45,1513.94894391738,6,6,3,0.218478003384791,45,30,9.79594879845812
"Bautista Agut R.",1701.54415464613,41,1619.97658130266,23,1518.40696915454,5,1581.36332148985,13,1500,0,1596.08806757873,18,1659.69962546989,32,1548.67301623615,9,9,6,2.10278534241088,32,19,5.95898084343442
"Cecchinato M.",1424.06389130281,20,1461.92290322279,4,1500,0,1427.6193995735,16,1500,0,1432.76667138363,16,1430.55875663898,17,1473.73985896845,3,3,0,-0.46633468778055,17,2,-2.57110966010705
"Pavlasek A.",1507.89382235281,6,1491.30093504232,1,1500,0,1516.01807567383,5,1500,0,1516.65777283448,5,1500.83195116544,4,1505.31117737532,2,2,1,0.2206869911171,4,2,0.0950659029952889
"Bourgue M.",1511.79758106152,2,1500,0,1500,0,1510.94847697516,2,1500,0,1511.48244628229,2,1500,0,1511.01563772446,2,2,1,0.471903242460939,0,0,0
"Kozlov S.",1490.77396398028,9,1465.81900800389,3,1503.21431804243,6,1500,0,1500,0,1501.03228997257,6,1487.63679239911,9,1500,0,0,0,0,9,3,-0.36904144078896
"Medvedev D.",1522.99276419856,10,1522.10166455355,5,1499.98875138098,2,1489.33777150494,3,1500,0,1488.85131201619,5,1521.78538137853,10,1500,0,0,0,0,10,5,0.919710567942348
"Escobedo E.",1491.38218290563,6,1490.01140045292,3,1490.78745560839,3,1500,0,1500,0,1493.9418370326,3,1489.26346280411,4,1497.3905855264,2,2,1,0.0575193954534574,4,1,-0.402232079228383
"Willis M.",1512.39706662037,2,1500,0,1507.80912126621,2,1500,0,1500,0,1506.88338922967,2,1500,0,1510.86254080347,2,2,1,0.495882664814771,0,0,0
"Hemery C.",1498.25051637336,3,1500,0,1500,0,1499.7673237745,3,1500,0,1498.27390978409,3,1497.47641252362,3,1500,0,0,0,0,3,1,-0.06997934506562
"Soderlund C.",1505.01180148047,2,1500,0,1500,0,1503.9065340874,2,1500,0,1503.91046590461,2,1503.97699806534,2,1500,0,0,0,0,2,1,0.200472059218602
"Kicker N.",1497.87066007545,3,1500,0,1500,0,1492.69381418462,3,1500,0,1492.51315351829,3,1497.36241416003,3,1500,0,0,0,0,3,1,-0.0851735969820632
"Wessels L.",1504.01778881182,2,1500,0,1500,0,1502.76356436455,2,1500,0,1501.85077795955,2,1504.67454777274,2,1500,0,0,0,0,2,1,0.160711552472988
"Mertl J.",1505.61251254575,2,1500,0,1500,0,1502.26123127582,2,1500,0,1503.22960935589,2,1503.9524853595,2,1500,0,0,0,0,2,1,0.224500501829867
"Lamasine T.",1488.1824712949,4,1500,0,1490.78737908924,1,1492.57109144921,3,1500,0,1486.34527721923,4,1491.32843663819,3,1492.91813611412,1,1,0,-0.240373172206915,3,1,-0.232327975996915
"Munoz De La Nava D.",1442.51456122626,8,1500,0,1500,0,1437.29090158771,8,1500,0,1439.10918069262,8,1451.15655990078,7,1484.764756613,1,1,0,-0.476683655202474,7,1,-1.82273389574726
"Cacic N.",1507.19348329555,2,1500,0,1500,0,1503.66468395084,2,1500,0,1503.89790646976,2,1504.79553683046,2,1500,0,0,0,0,2,1,0.287739331821833
"Diez S.",1473.76636147875,5,1494.01991609305,3,1500,0,1474.52713389164,2,1500,0,1474.66678045415,2,1473.60128026312,5,1500,0,0,0,0,5,1,-1.04934554085016
"Shapovalov D.",1504.23479726792,3,1502.05596939406,3,1500,0,1500,0,1500,0,1500,0,1502.51861590141,3,1500,0,0,0,0,3,1,0.169391890716833
"Opelka R.",1547.85941145743,10,1548.51847570534,9,1500,0,1489.59991985693,1,1500,0,1492.78620406578,1,1542.00571934653,10,1500,0,0,0,0,10,5,1.9143764582971
"Satral J.",1503.18157274992,3,1508.88181874227,2,1500,0,1494.79579184993,1,1500,0,1494.26142660856,1,1493.56062436955,1,1507.03930541276,2,2,1,0.369497094413708,1,0,-0.242234184417074
"Wu D.",1445.9928781755,17,1430.06474238388,17,1500,0,1500,0,1500,0,1500,0,1465.53087063283,14,1461.57536894309,3,3,0,-1.15823912832609,14,2,-1.00204574465404
"Whittington A.",1507.91528043138,2,1507.08641827185,2,1500,0,1500,0,1500,0,1500,0,1507.53250280687,2,1500,0,0,0,0,2,1,0.316611217255071
"Bublik A.",1512.7383589599,4,1508.73356608459,4,1500,0,1500,0,1500,0,1500,0,1511.37655106632,4,1500,0,0,0,0,4,2,0.509534358395985
"Ymer M.",1504.44994324533,3,1498.11503997538,3,1500,0,1500,0,1500,0,1500,0,1503.00017279374,3,1500,0,0,0,0,3,1,0.177997729813105
NA,1487.5,2,1500,0,1500,0,1500,0,1500,0,1487.5,2,1500,0,1500,0,0,0,0,0,0,0
"Kumar S.",1487.5,1,1487.5,1,1500,0,1500,0,1500,0,1500,0,1487.5,1,1500,0,0,0,0,1,0,-0.5
"Spottl M.",1476.30632494379,2,1487.5,1,1500,0,1487.94952970932,1,1500,0,1487.94952970932,1,1476.70801841533,2,1500,0,0,0,0,2,0,-0.947747002248216
"Kilderry P.",1465.50196613381,3,1476.43059672736,2,1487.53285919994,1,1500,0,1500,0,1486.43182867723,1,1477.88807087411,2,1487.03431883644,1,1,0,-0.512595933935963,2,0,-0.867325420711678
"Ishii Y.",1451.67875726295,4,1450.1681471853,4,1500,0,1500,0,1500,0,1500,0,1450.92093593032,4,1500,0,0,0,0,4,0,-1.93284970948207
"Al-Alawi S.K.",1477.35382814485,2,1476.70103448973,2,1500,0,1500,0,1500,0,1500,0,1476.67976854134,2,1500,0,0,0,0,2,0,-0.905846874205934
"Luxa P.",1427.32162995725,7,1446.38698415853,5,1478.98143414785,2,1500,0,1500,0,1477.55141343525,2,1434.55156735597,6,1488.34801518559,1,1,0,-0.284234381112788,6,0,-2.62290042059727
"Sanchez J.",1487.5,1,1487.5,1,1500,0,1500,0,1500,0,1500,0,1487.5,1,1500,0,0,0,0,1,0,-0.5
"Costa F.",1453.53584227852,4,1475.37197096268,2,1500,0,1475.46916770222,2,1500,0,1475.42214282843,2,1452.57695527316,4,1500,0,0,0,0,4,0,-1.85856630885905
"Karbacher B.",1476.8182945488,2,1487.5,1,1500,0,1490.01983832257,1,1500,0,1489.30744084328,1,1488.42148939367,1,1487.5,1,1,0,-0.5,1,0,-0.427268218048157
"Kulti N.",1443.87161364371,5,1477.25226343296,2,1487.5,1,1476.30322947157,2,1500,0,1464.17857388682,3,1453.5169095613,4,1487.5,1,1,0,-0.5,4,0,-1.74513545425152
"Raoux G.",1476.13666343609,2,1486.60210182637,1,1500,0,1490.19875398687,1,1500,0,1490.19875398687,1,1487.05047029068,1,1487.94952970932,1,1,0,-0.418617535611414,1,0,-0.535915926945102
"Humphries S.",1457.55377365069,4,1466.78068029028,3,1500,0,1488.88517875201,1,1500,0,1488.88517875201,1,1456.07062128465,4,1500,0,0,0,0,4,0,-1.69784905397225
"Jensen L.",1487.193203992,1,1487.193203992,1,1500,0,1500,0,1500,0,1500,0,1487.54666650777,1,1500,0,0,0,0,1,0,-0.512271840320018
"Knowles M.",1473.66691066384,2,1473.9774004463,2,1500,0,1500,0,1500,0,1500,0,1473.7730632567,2,1500,0,0,0,0,2,0,-1.05332357344649
"Stark J.",1474.37479122087,2,1487.17747193893,1,1487.40845347911,1,1500,0,1500,0,1487.40016717474,1,1474.21317893801,2,1500,0,0,0,0,2,0,-1.02500835116534
"Szymanski J.",1488.1922155324,1,1488.69340830561,1,1500,0,1500,0,1500,0,1500,0,1488.19673314412,1,1500,0,0,0,0,1,0,-0.472311378704136
"Gonzalez P.",1486.5699717041,1,1500,0,1500,0,1487.05047029068,1,1500,0,1487.05047029068,1,1486.58603521976,1,1500,0,0,0,0,1,0,-0.537201131836122
"Cortes J.",1489.34412804458,1,1500,0,1500,0,1490.03380633673,1,1500,0,1490.03380633673,1,1489.63728893529,1,1500,0,0,0,0,1,0,-0.426234878216702
"Harper-Griffith L.",1478.3453841067,2,1488.00431612765,1,1500,0,1487.5,1,1500,0,1487.5,1,1487.02758889245,1,1487.44071402391,1,1,0,-0.338869175302293,1,0,-0.527315460429663
"Marques N.",1488.96081715722,1,1500,0,1500,0,1487.5,1,1500,0,1487.5,1,1488.28924682315,1,1500,0,0,0,0,1,0,-0.44156731371111
"Garcia M.",1477.75071737273,2,1500,0,1489.05126175977,1,1487.5,1,1500,0,1477.01045153717,2,1478.4388284006,2,1500,0,0,0,0,2,0,-0.889971305090894
"Fahlke A.",1487.30579267943,1,1500,0,1500,0,1487.06662324804,1,1500,0,1487.06662324804,1,1487.55437296487,1,1500,0,0,0,0,1,0,-0.507768292822706
"Witt A.",1485.33285954229,1,1500,0,1487.5,1,1500,0,1500,0,1486.59834438393,1,1485.72465410557,1,1500,0,0,0,0,1,0,-0.586685618308533
"Landsberg J.",1488.19303627943,1,1500,0,1487.5,1,1500,0,1500,0,1488.41516063142,1,1488.3218158495,1,1500,0,0,0,0,1,0,-0.472278548822773
"Boruszewski J.",1486.23291811231,1,1500,0,1487.05047029068,1,1500,0,1500,0,1485.84333782763,1,1486.59435159361,1,1500,0,0,0,0,1,0,-0.550683275507499
"Gaudi I.",1489.16971005653,1,1500,0,1487.5,1,1500,0,1500,0,1487.90038275359,1,1500,0,1489.21036834272,1,1,0,-0.433211597738792,0,0,0
"Bhupathi M.",1458.55477795925,3,1472.90963439048,2,1487.05047029068,1,1500,0,1500,0,1485.81696665046,1,1473.23782680919,2,1487.03431883644,1,1,0,-0.58078597319884,2,0,-1.07702290843098
"MacLagan M.",1472.11928391158,2,1484.90089059927,1,1487.46879591686,1,1500,0,1500,0,1487.38290027092,1,1484.68206284555,1,1487.5,1,1,0,-0.506324627517498,1,0,-0.608904016019128
"Timfjord N.",1485.42546234492,1,1500,0,1500,0,1486.32849315979,1,1500,0,1485.93633815433,1,1485.92318548771,1,1500,0,0,0,0,1,0,-0.582981506203337
"Fleischfresser T.",1485.57146487695,1,1500,0,1500,0,1486.38748850159,1,1500,0,1485.74049277651,1,1486.24162254538,1,1500,0,0,0,0,1,0,-0.577141404922123
"Arnold L.",1485.72737509472,1,1500,0,1500,0,1486.73501941213,1,1500,0,1485.49446860097,1,1486.71676127911,1,1500,0,0,0,0,1,0,-0.570904996211348
"Thomas J.",1473.72170424287,2,1485.14454530429,1,1488.36798559581,1,1500,0,1500,0,1488.3874797951,1,1473.74470516725,2,1500,0,0,0,0,2,0,-1.0511318302852
"Tiilikainen K.",1478.45638777046,2,1500,0,1500,0,1475.09420458815,2,1500,0,1475.80026215439,2,1478.5327210867,2,1500,0,0,0,0,2,0,-0.861744489181483
"Filippini M.",1476.81150684089,2,1500,0,1500,0,1477.73206079629,2,1500,0,1476.82430117533,2,1477.64557934487,2,1500,0,0,0,0,2,0,-0.92753972636456
"Miketa D.",1489.64686241562,1,1500,0,1500,0,1488.8067291179,1,1500,0,1488.5882366818,1,1488.77722167567,1,1500,0,0,0,0,1,0,-0.414125503375188
"Peschek D.",1488.36492282123,1,1500,0,1500,0,1487.21912092491,1,1500,0,1488.71469240311,1,1488.28614387785,1,1500,0,0,0,0,1,0,-0.465403087150754
"Vajda I.",1478.19932666368,2,1500,0,1500,0,1478.15490292748,2,1500,0,1477.7128723409,2,1479.32609285462,2,1500,0,0,0,0,2,0,-0.872026933452661
"Moretti H.",1488.63832896601,1,1500,0,1500,0,1488.53488575578,1,1500,0,1488.53488575578,1,1488.09314859492,1,1500,0,0,0,0,1,0,-0.454466841359543
"Trimmel C.",1479.56343068997,2,1500,0,1500,0,1479.21522613043,2,1500,0,1479.14149028635,2,1479.5757000899,2,1500,0,0,0,0,2,0,-0.817462772401276
"Vasek R.",1487.49579726783,1,1500,0,1500,0,1487.33335948028,1,1500,0,1487.36071422101,1,1487.12994468016,1,1500,0,0,0,0,1,0,-0.500168109286677
"Fasching A.",1487.44725729058,1,1500,0,1500,0,1487.66373726375,1,1500,0,1487.11401799652,1,1488.22132713935,1,1500,0,0,0,0,1,0,-0.502109708376966
"Cabello F.",1485.74913767491,1,1500,0,1500,0,1486.99643150406,1,1500,0,1486.70056587855,1,1486.10353637997,1,1500,0,0,0,0,1,0,-0.570034493003543
"Cobolli S.",1489.34046019941,1,1500,0,1500,0,1490.29772565237,1,1500,0,1489.66751285206,1,1488.90921511698,1,1500,0,0,0,0,1,0,-0.426381592023582
"Malcor O.",1471.8901652205,2,1500,0,1500,0,1472.61798124181,2,1500,0,1471.85202032814,2,1473.05157347433,2,1500,0,0,0,0,2,0,-1.12439339117985
"Tramacchi P.",1487.31839103294,1,1486.76061256292,1,1500,0,1500,0,1500,0,1500,0,1487.81971118125,1,1500,0,0,0,0,1,0,-0.507264358682294
"Mor L.",1487.30934559922,1,1487.64918591405,1,1500,0,1500,0,1500,0,1500,0,1487.23488231109,1,1500,0,0,0,0,1,0,-0.507626176031037
"Caldwell D.",1486.98631595699,1,1487.5,1,1500,0,1500,0,1500,0,1500,0,1487.00184355276,1,1500,0,0,0,0,1,0,-0.520547361720271
"Harsanyi P.",1475.41128996281,2,1473.58826250322,2,1500,0,1500,0,1500,0,1500,0,1475.00962184627,2,1500,0,0,0,0,2,0,-0.98354840148756
"Kauffmann C.",1480.12320556396,2,1485.73093559435,1,1500,0,1486.1172089143,1,1500,0,1490.25673299876,1,1500,0,1480.1519071608,2,2,0,-0.795071777441639,0,0,0
"Herm-Zahlava J.",1473.06144293357,2,1500,0,1500,0,1473.63697505522,2,1500,0,1473.44448999822,2,1473.66183197938,2,1500,0,0,0,0,2,0,-1.07754228265729
"Tong M.",1488.53339301921,1,1486.4682441455,1,1500,0,1500,0,1500,0,1500,0,1487.58091064217,1,1500,0,0,0,0,1,0,-0.45866427923143
"Onoda M.",1449.757997464,4,1451.35010006477,4,1500,0,1500,0,1500,0,1500,0,1450.8935314004,4,1500,0,0,0,0,4,0,-2.00968010144019
"Miyao J.",1475.47928046289,2,1478.01701483408,2,1500,0,1500,0,1500,0,1500,0,1476.31141786307,2,1500,0,0,0,0,2,0,-0.980828781484527
"Mlynarik Z.",1490.55429202359,1,1488.8597992495,1,1500,0,1500,0,1500,0,1500,0,1490.3673674463,1,1500,0,0,0,0,1,0,-0.377828319056317
"Zhang Y.",1487.18987476134,1,1486.74045106283,1,1500,0,1500,0,1500,0,1500,0,1487.02527902609,1,1500,0,0,0,0,1,0,-0.512405009546282
"Golovanov D.",1459.76824256283,5,1491.51767711081,1,1485.4129468086,1,1500,0,1467.16697332023,3,1461.8380157835,4,1471.4187102909,4,1485.64176589579,1,1,0,-0.547320511639334,4,0,-1.06194978584747
"Kornienko I.",1495.2356838626,1,1493.49923334255,1,1500,0,1500,0,1500,0,1500,0,1494.05074476465,1,1500,0,0,0,0,1,0,-0.190572645496105
"Freelove O.",1488.91401316778,1,1487.07709401067,1,1500,0,1500,0,1500,0,1500,0,1488.98226185829,1,1500,0,0,0,0,1,0,-0.443439473288889
"Milligan L.",1485.79114608456,2,1487.03429066708,1,1487.05047029068,1,1500,0,1500,0,1495.57373468296,1,1487.95340749584,1,1491.4141729359,1,1,0,-0.154136123653471,1,0,-0.414218032964007
"Sarstrand M.",1482.99745422377,2,1488.23340498301,1,1500,0,1494.44961762298,1,1500,0,1493.87295252787,1,1482.02861801012,2,1500,0,0,0,0,2,0,-0.680101831049209
"Smith L.",1489.83981853261,1,1490.00012346342,1,1500,0,1500,0,1500,0,1500,0,1489.4791656253,1,1500,0,0,0,0,1,0,-0.40640725869552
"Syed F.",1484.54226786728,1,1486.13975426745,1,1500,0,1500,0,1500,0,1500,0,1484.60937995391,1,1500,0,0,0,0,1,0,-0.618309285308735
"Breen M.",1485.99593942127,1,1486.13270745657,1,1500,0,1500,0,1500,0,1500,0,1500,0,1486.6181929939,1,1,0,-0.560162423149151,0,0,0
"Perry T.",1488.19835022987,1,1487.61516662242,1,1500,0,1500,0,1500,0,1500,0,1500,0,1488.09148997889,1,1,0,-0.472065990805242,0,0,0
"Svarc L.",1477.59977248083,2,1488.44902321627,1,1500,0,1489.13183964878,1,1500,0,1487.88404204471,1,1489.74481889412,1,1488.03217388544,1,1,0,-0.493893580027508,1,0,-0.402115520739168
"Moyano D.",1474.32930609556,2,1500,0,1500,0,1474.80656031102,2,1500,0,1474.68588399309,2,1474.80226909488,2,1500,0,0,0,0,2,0,-1.02682775617776
"Koll H.",1484.79970714286,1,1485.63726487658,1,1500,0,1500,0,1500,0,1500,0,1484.90686108861,1,1500,0,0,0,0,1,0,-0.608011714285717
"Arquez P.",1487.15270559017,1,1500,0,1500,0,1488.06838758785,1,1500,0,1488.03885206101,1,1487.94784932942,1,1500,0,0,0,0,1,0,-0.513891776393069
"Eagle J.",1489.10246764026,1,1488.05562443818,1,1500,0,1500,0,1500,0,1500,0,1489.03117500141,1,1500,0,0,0,0,1,0,-0.435901294389579
"Bahrouzyan O.",1446.16631563661,7,1441.45604074628,7,1500,0,1500,0,1500,0,1500,0,1441.16562351786,7,1500,0,0,0,0,7,0,-2.15334737453577
"Belal C.",1486.73805203815,1,1500,0,1500,0,1488.93895204411,1,1500,0,1488.51749354491,1,1486.83891187528,1,1500,0,0,0,0,1,0,-0.530477918474051
"Couto E.",1486.06892898363,1,1500,0,1500,0,1486.51568839184,1,1500,0,1486.17067064664,1,1485.20183367438,1,1500,0,0,0,0,1,0,-0.557242840654623
"Sousa T.",1486.87270637075,1,1500,0,1500,0,1487.96247731529,1,1500,0,1487.07600149779,1,1487.18646251913,1,1500,0,0,0,0,1,0,-0.525091745170037
"Navarra M.",1488.82668476427,1,1500,0,1500,0,1490.10870128481,1,1500,0,1489.76197381493,1,1489.48377664524,1,1500,0,0,0,0,1,0,-0.446932609429076
"Derepasko A.",1493.65899555393,1,1500,0,1489.01494813735,1,1500,0,1500,0,1490.474868292,1,1500,0,1490.89034266623,1,1,0,-0.253640177842935,0,0,0
"Vlasov D.",1489.94431257746,1,1500,0,1500,0,1491.39293963992,1,1500,0,1490.26881774682,1,1490.29750657373,1,1500,0,0,0,0,1,0,-0.402227496901625
"Tkalec M.",1487.26556954312,1,1500,0,1500,0,1488.57725421373,1,1500,0,1488.51312285047,1,1487.25328171489,1,1500,0,0,0,0,1,0,-0.509377218275035
"Bozic I.",1486.60660965177,1,1500,0,1500,0,1486.67622950858,1,1500,0,1486.67557093898,1,1487.07192788892,1,1500,0,0,0,0,1,0,-0.535735613929186
"Pfeiffer K.",1491.01145136183,1,1500,0,1500,0,1490.38448086801,1,1500,0,1490.63913256555,1,1490.66105253236,1,1500,0,0,0,0,1,0,-0.359541945526651
"Peppas S.",1490.51645790522,1,1500,0,1500,0,1491.86003385844,1,1500,0,1490.99932322666,1,1490.27335453048,1,1500,0,0,0,0,1,0,-0.37934168379119
"Oncins J.",1486.14221537145,1,1487.29141496399,1,1500,0,1500,0,1500,0,1500,0,1486.67879578169,1,1500,0,0,0,0,1,0,-0.554311385142178
"Tomashevich D.",1487.83240020639,1,1490.54136187308,1,1500,0,1500,0,1500,0,1500,0,1487.63855370341,1,1500,0,0,0,0,1,0,-0.486703991744455
"Jiang S.",1486.78737128407,1,1489.02949817689,1,1500,0,1500,0,1500,0,1500,0,1487.44893267403,1,1500,0,0,0,0,1,0,-0.528505148637106
"Wang Y.",1459.46119625224,4,1468.73105973702,3,1500,0,1488.14872560047,1,1500,0,1487.83778364634,1,1458.59187252823,4,1500,0,0,0,0,4,0,-1.62155214991027
"Koenig R.",1484.38888538071,1,1487.6789418663,1,1500,0,1500,0,1500,0,1500,0,1484.60795071776,1,1500,0,0,0,0,1,0,-0.624444584771454
"Shimada T.",1472.82931907474,2,1488.01155102301,1,1487.05047029068,1,1500,0,1500,0,1485.67571015794,1,1473.39351459421,2,1500,0,0,0,0,2,0,-1.08682723701021
"Hui J.",1494.9255833273,1,1494.58348798335,1,1500,0,1500,0,1500,0,1500,0,1493.25634043111,1,1500,0,0,0,0,1,0,-0.202976666908074
"Garcia-Sintes J.",1488.4945378498,1,1500,0,1500,0,1489.83677377415,1,1500,0,1489.22671784611,1,1488.49849145167,1,1500,0,0,0,0,1,0,-0.460218486007978
"Zitko R.",1475.11441437634,2,1486.72442235371,1,1500,0,1487.22256596704,1,1500,0,1486.78064971084,1,1474.5651189006,2,1500,0,0,0,0,2,0,-0.995423424946593
"Dupre T.",1486.58722347525,1,1487.09422415995,1,1500,0,1500,0,1500,0,1500,0,1486.54463950358,1,1500,0,0,0,0,1,0,-0.536511060990138
"Al Khulaifi N.G.",1486.89499843964,1,1486.84237822244,1,1500,0,1500,0,1500,0,1500,0,1486.81939275256,1,1500,0,0,0,0,1,0,-0.524200062414287
"Willman D.",1490.81303580967,1,1489.84446145466,1,1500,0,1500,0,1500,0,1500,0,1490.81031970907,1,1500,0,0,0,0,1,0,-0.367478567613239
"Hormazabal G.",1463.50044796728,3,1500,0,1500,0,1467.2310736341,3,1500,0,1466.31175632514,3,1464.94165002991,3,1500,0,0,0,0,3,0,-1.4599820813087
"Olguin L.",1493.07012164319,1,1500,0,1500,0,1492.92691764391,1,1500,0,1492.15732072949,1,1492.2510594183,1,1500,0,0,0,0,1,0,-0.277195134272521
"Mazarakis V.",1467.43979462276,5,1486.32102402889,2,1500,0,1476.57583462829,3,1500,0,1476.22363948277,3,1466.85812372791,5,1500,0,0,0,0,5,0,-1.30240821508943
"Matias N.",1489.4098286599,1,1500,0,1500,0,1490.323602143,1,1500,0,1490.06380654932,1,1489.53860672649,1,1500,0,0,0,0,1,0,-0.423606853604007
"Marin L.",1490.62463317365,1,1500,0,1500,0,1490.58867241758,1,1500,0,1490.09219799952,1,1490.9181954343,1,1500,0,0,0,0,1,0,-0.375014673054077
"Albert M.",1489.55271144519,1,1500,0,1500,0,1490.09725652494,1,1500,0,1489.5560200475,1,1489.33000475055,1,1500,0,0,0,0,1,0,-0.417891542192262
"Ager J.",1473.56254948287,2,1500,0,1500,0,1475.16858467856,2,1500,0,1474.71971200426,2,1474.40244638499,2,1500,0,0,0,0,2,0,-1.05749802068517
"Dreekmann H.",1489.59826350991,2,1500,0,1477.24284340865,2,1500,0,1500,0,1484.92206958731,2,1488.57410516798,2,1500,0,0,0,0,2,0,-0.416069459603787
"Coetzee J.",1489.33307729721,1,1500,0,1487.1085889547,1,1500,0,1500,0,1487.04220520731,1,1489.29573250361,1,1500,0,0,0,0,1,0,-0.426676908111453
"Ivanov-Smolensky K.",1472.35148865052,2,1487.74432044863,1,1487.09484338784,1,1500,0,1500,0,1486.76124973996,1,1473.68605427739,2,1500,0,0,0,0,2,0,-1.10594045397928
"Mackin A.",1407.56260890793,11,1487.27071600461,1,1431.28176408051,6,1482.50202451846,2,1475.19864086809,2,1408.83632988038,10,1438.19447104472,6,1449.09937080333,5,5,0,-1.44843395357932,6,0,-2.24906169010357
"Todero N.",1488.57894727362,1,1500,0,1500,0,1488.1243563474,1,1500,0,1487.02440511659,1,1488.4581447844,1,1500,0,0,0,0,1,0,-0.456842109055358
"Ellwood B.",1485.07948839757,1,1500,0,1487.08393385482,1,1500,0,1500,0,1486.20999011832,1,1484.87651748224,1,1500,0,0,0,0,1,0,-0.596820464097045
"Kennedy A.",1469.56571784397,3,1480.86078638318,2,1486.20702040592,1,1500,0,1500,0,1486.36889909228,1,1468.6312934034,3,1500,0,0,0,0,3,0,-1.21737128624121
"Nijaki R.",1488.70541914884,1,1500,0,1500,0,1488.8092905224,1,1500,0,1488.58526769132,1,1487.17656988033,1,1500,0,0,0,0,1,0,-0.451783234046231
"Dabrowski B.",1490.71826528712,2,1500,0,1500,0,1487.9907582828,2,1500,0,1489.42212806952,2,1487.80965327683,2,1500,0,0,0,0,2,0,-0.371269388515063
"Agaev E.",1489.65024821517,1,1488.17194499842,1,1500,0,1500,0,1500,0,1500,0,1488.69325948349,1,1500,0,0,0,0,1,0,-0.413990071393342
"Spracklin T.",1485.25228539634,1,1485.88291963335,1,1500,0,1500,0,1500,0,1500,0,1485.48983246865,1,1500,0,0,0,0,1,0,-0.589908584146495
"Hanley P.",1487.73089607115,1,1485.81727880318,1,1500,0,1500,0,1500,0,1500,0,1488.05269797444,1,1500,0,0,0,0,1,0,-0.490764157153993
"Lukaev R.",1486.18206238166,1,1484.84218403415,1,1500,0,1500,0,1500,0,1500,0,1500,0,1486.33099399538,1,1,0,-0.552717504733471,0,0,0
"Kunitcin I.",1486.31258713318,1,1486.61529400502,1,1500,0,1500,0,1500,0,1500,0,1500,0,1486.19852786865,1,1,0,-0.547496514672976,0,0,0
"Craca M.",1486.07384054679,1,1500,0,1500,0,1485.80432561013,1,1500,0,1485.65177793257,1,1486.51613081183,1,1500,0,0,0,0,1,0,-0.55704637812854
"Bohaboy D.",1485.99505480281,1,1484.92284420204,1,1500,0,1500,0,1500,0,1500,0,1486.16113254601,1,1500,0,0,0,0,1,0,-0.560197807887627
"Shvec A.",1493.82972170154,1,1489.52014150152,1,1500,0,1500,0,1500,0,1500,0,1493.81917630055,1,1500,0,0,0,0,1,0,-0.246811131938211
"Khalfan S.",1463.64307635054,3,1460.19922164325,3,1500,0,1500,0,1500,0,1500,0,1463.44881081683,3,1500,0,0,0,0,3,0,-1.45427694597858
"Rea S.",1477.06024946938,2,1475.77995279798,2,1500,0,1500,0,1500,0,1500,0,1475.60692718425,2,1500,0,0,0,0,2,0,-0.917590021224818
"Durek R.",1488.93839097313,1,1488.05942416087,1,1500,0,1500,0,1500,0,1500,0,1488.57460149647,1,1500,0,0,0,0,1,0,-0.442464361074765
"Henry R.",1484.23751189223,1,1485.337222933,1,1500,0,1500,0,1500,0,1500,0,1500,0,1486.88911541988,1,1,0,-0.630499524310987,0,0,0
"Peralta J.",1487.43578038573,1,1500,0,1500,0,1488.96720627435,1,1500,0,1488.19981421109,1,1487.12486743061,1,1500,0,0,0,0,1,0,-0.502568784570997
"Gallardo Valles M.",1485.71597794773,2,1500,0,1500,0,1486.78704422993,2,1500,0,1485.59528331464,2,1486.72479449892,2,1500,0,0,0,0,2,0,-0.571360882090861
"Norby R.",1485.92051540627,1,1485.14447271415,1,1500,0,1500,0,1500,0,1500,0,1487.18629420884,1,1500,0,0,0,0,1,0,-0.563179383749197
"Gooding J.",1493.22801442651,1,1492.06966035658,1,1500,0,1500,0,1500,0,1500,0,1492.58267071157,1,1500,0,0,0,0,1,0,-0.270879422939505
"Ouahabi T.",1489.66762250242,1,1500,0,1500,0,1488.75342279908,1,1500,0,1487.7827894886,1,1489.6352316334,1,1500,0,0,0,0,1,0,-0.41329509990322
"Lopes H.",1491.15020419773,1,1500,0,1500,0,1490.60385596838,1,1500,0,1490.22367531396,1,1490.53358202445,1,1500,0,0,0,0,1,0,-0.353991832090926
"Mathieu P.",1472.70863011172,5,1492.4886555753,1,1496.58222771439,1,1486.4456407274,2,1489.12634947963,1,1474.60506637876,4,1472.65079830362,4,1497.57934346576,1,1,0,-0.0213415732534386,4,0,-1.07031322227771
"Weinzierl J.",1485.61453181025,1,1500,0,1500,0,1486.99670644259,1,1500,0,1486.3834688699,1,1485.57345500385,1,1500,0,0,0,0,1,0,-0.575418727590009
"Delfino M.",1487.8522759927,1,1500,0,1500,0,1487.26896776358,1,1500,0,1487.49923441296,1,1500,0,1487.61372954478,1,1,0,-0.48590896029191,0,0,0
"Koderisch C.",1492.57452105765,1,1500,0,1487.43671580258,1,1500,0,1500,0,1491.33248011337,1,1491.53547535047,1,1500,0,0,0,0,1,0,-0.297019157693893
"Logtens P.",1485.56687798363,2,1500,0,1476.67850052586,2,1500,0,1500,0,1478.52783086377,2,1484.64541865146,2,1500,0,0,0,0,2,0,-0.57732488065469
"Moser F.",1482.0270812186,2,1487.5,1,1488.7783046609,1,1500,0,1500,0,1493.97683074789,1,1480.96466364447,2,1500,0,0,0,0,2,0,-0.718916751256006
"Andersson H.",1486.94935230995,1,1500,0,1500,0,1487.5,1,1500,0,1487.5,1,1487.5,1,1500,0,0,0,0,1,0,-0.522025907601877
"Prpic A.",1473.57693721241,2,1500,0,1500,0,1473.71437461593,2,1500,0,1472.59580970827,2,1474.48445313941,2,1500,0,0,0,0,2,0,-1.05692251150367
"Levinsky J.",1484.44166915785,1,1500,0,1500,0,1483.27636376288,1,1500,0,1484.70354698361,1,1484.0142273382,1,1500,0,0,0,0,1,0,-0.622333233686154
"Levine I.",1474.71623641636,2,1487.04783345211,1,1487.5,1,1500,0,1500,0,1487.26103227729,1,1473.90365588217,2,1500,0,0,0,0,2,0,-1.01135054334559
"Behrmann M.",1486.00499147765,1,1484.08546779075,1,1500,0,1500,0,1500,0,1500,0,1486.51026003717,1,1500,0,0,0,0,1,0,-0.559800340893908
"Ayala D.",1486.31709174327,1,1486.27850466771,1,1500,0,1500,0,1500,0,1500,0,1486.59926501795,1,1500,0,0,0,0,1,0,-0.547316330269352
"Neumuller I.",1489.49741405372,1,1500,0,1500,0,1487.33070699439,1,1500,0,1489.15043559377,1,1489.67634673288,1,1500,0,0,0,0,1,0,-0.420103437851388
"Yim R.",1486.12823257103,2,1484.03961727593,2,1500,0,1500,0,1500,0,1500,0,1491.41558857649,1,1490.31978064929,1,1,0,-0.272971384014744,1,0,-0.281899313144247
"Fyrstenberg M.",1473.55417978615,3,1500,0,1500,0,1472.65498146242,3,1500,0,1472.13318928058,3,1473.54796246267,3,1500,0,0,0,0,3,0,-1.05783280855407
"Matkowski M.",1477.80834022772,2,1500,0,1500,0,1480.99139995271,2,1500,0,1478.59284677316,2,1477.56894310817,2,1500,0,0,0,0,2,0,-0.887666390891388
"Urban F.",1475.34935252516,2,1500,0,1500,0,1473.12312889247,2,1500,0,1474.27990219844,2,1475.86098327798,2,1500,0,0,0,0,2,0,-0.986025898993751
"Carlson A.",1486.34967746328,1,1486.93469325497,1,1500,0,1500,0,1500,0,1500,0,1486.55374222626,1,1500,0,0,0,0,1,0,-0.546012901468601
"Quintero M.",1486.58760820987,1,1500,0,1500,0,1487.23731143526,1,1500,0,1487.16248120514,1,1487.13245213936,1,1500,0,0,0,0,1,0,-0.536495671605205
"Moraru G.",1476.8465932242,2,1500,0,1500,0,1478.0691625053,2,1500,0,1477.31415790041,2,1475.8919750642,2,1500,0,0,0,0,2,0,-0.926136271032157
"Ratiwatana S.",1487.09957671059,1,1487.68521520089,1,1500,0,1500,0,1500,0,1500,0,1487.11994460475,1,1500,0,0,0,0,1,0,-0.516016931576489
"Snobel P.",1465.54021612191,4,1469.30259354156,3,1489.45519505603,1,1500,0,1500,0,1490.4323282052,1,1483.89583195705,2,1472.99703953909,2,2,0,-0.79846289869248,2,0,-0.57992845643131
"Scherrer J.",1498.18260507231,1,1500,0,1500,0,1500,0,1488.54268241072,1,1495.16562112692,1,1497.43804003072,1,1500,0,0,0,0,1,0,-0.0726957971075038
"Davletshin V.",1478.19338144352,2,1488.19190893981,1,1500,0,1500,0,1488.43617787167,1,1491.64436843255,1,1477.8974381224,2,1500,0,0,0,0,2,0,-0.872264742259045
"Andersen J.",1485.09392234977,1,1485.79743830862,1,1500,0,1500,0,1500,0,1500,0,1485.62080522863,1,1500,0,0,0,0,1,0,-0.596243106009355
"Mankad H.",1461.08642769582,3,1473.39076632751,2,1487.78472145478,1,1500,0,1500,0,1485.64497718297,1,1461.99541012592,3,1500,0,0,0,0,3,0,-1.55654289216704
"Reichel A.",1493.0805622055,1,1493.34266230283,1,1500,0,1500,0,1500,0,1500,0,1493.32251662557,1,1500,0,0,0,0,1,0,-0.276777511780196
"Braga P.",1488.44298679025,1,1500,0,1500,0,1489.86675156435,1,1500,0,1489.58715749716,1,1489.01616950621,1,1500,0,0,0,0,1,0,-0.462280528390194
"Gallardo M.",1479.74335923984,2,1500,0,1500,0,1482.26262431067,2,1500,0,1480.62573132083,2,1479.8849016266,2,1500,0,0,0,0,2,0,-0.81026563040624
"Phillips T.",1491.78694294589,1,1490.83072800162,1,1500,0,1500,0,1500,0,1500,0,1490.7221044718,1,1500,0,0,0,0,1,0,-0.328522282164461
"Burniol G.",1477.28390242041,2,1500,0,1500,0,1476.56121309555,2,1500,0,1479.59071252884,2,1476.2380724301,2,1500,0,0,0,0,2,0,-0.908643903183541
"Matos-Gil I.",1488.64159130504,2,1500,0,1500,0,1485.08192923211,2,1500,0,1486.01119820657,2,1486.2840810505,2,1500,0,0,0,0,2,0,-0.454336347798332
"Haas P.",1487.69515968754,1,1500,0,1500,0,1487.85755343789,1,1500,0,1487.53311963583,1,1487.68017627521,1,1500,0,0,0,0,1,0,-0.492193612498539
"Ziadi M.",1448.83876714217,5,1500,0,1500,0,1448.0165505151,5,1500,0,1446.87610467682,5,1447.2869205239,5,1500,0,0,0,0,5,0,-2.04644931431328
"Fitz S.",1490.01848858157,1,1500,0,1488.09047218391,1,1500,0,1500,0,1489.64689610633,1,1489.70923261814,1,1500,0,0,0,0,1,0,-0.399260456737114
"Hellstrom M.",1487.68347392576,1,1500,0,1500,0,1486.39265550976,1,1500,0,1485.92322114764,1,1487.34963609009,1,1500,0,0,0,0,1,0,-0.492661042969798
"van der Meer N.",1490.45574208762,1,1500,0,1500,0,1491.43224966028,1,1500,0,1489.76381178315,1,1490.62346117014,1,1500,0,0,0,0,1,0,-0.38177031649514
"Cook L.",1486.95294962888,1,1486.40621035413,1,1500,0,1500,0,1500,0,1500,0,1486.6795654115,1,1500,0,0,0,0,1,0,-0.521882014844957
"Lu Y.",1454.52599972401,4,1453.49482259347,4,1500,0,1500,0,1500,0,1500,0,1452.78908089115,4,1500,0,0,0,0,4,0,-1.81896001103952
"Gimeno D.",1491.99096656873,1,1500,0,1500,0,1490.67503018653,1,1500,0,1491.26393302752,1,1491.39110586344,1,1500,0,0,0,0,1,0,-0.320361337250626
"Yoo D.",1489.45425520027,1,1500,0,1500,0,1488.85119837285,1,1500,0,1489.60689845243,1,1489.50286335105,1,1500,0,0,0,0,1,0,-0.421829791989273
"Benneteau A.",1487.34536681298,1,1488.05385859688,1,1500,0,1500,0,1500,0,1500,0,1500,0,1487.20665791017,1,1,0,-0.506185327480945,0,0,0
"Ionita V.",1467.69223919448,3,1500,0,1500,0,1466.26749742679,3,1500,0,1465.11096828483,3,1464.42520613144,3,1500,0,0,0,0,3,0,-1.29231043222098
"Bohane A.",1491.01294078654,1,1492.48058907183,1,1500,0,1500,0,1500,0,1500,0,1490.36087771619,1,1500,0,0,0,0,1,0,-0.359482368538407
"Pedroso A.",1492.71403276674,1,1492.60620432756,1,1500,0,1500,0,1500,0,1500,0,1493.28512312007,1,1500,0,0,0,0,1,0,-0.291438689330507
"Gruber K.",1491.85421747438,1,1491.50381328057,1,1500,0,1500,0,1500,0,1500,0,1491.58382695281,1,1500,0,0,0,0,1,0,-0.325831301024691
"Rascon T.",1490.8602840898,1,1490.13509702061,1,1500,0,1500,0,1500,0,1500,0,1489.85486475499,1,1500,0,0,0,0,1,0,-0.365588636407965
"Kimmich M.",1479.65810562427,3,1474.34832677033,3,1500,0,1500,0,1500,0,1500,0,1491.00753522834,1,1478.3654359553,2,2,0,-0.529274112107638,1,0,-0.28440166292142
"Abdulla M.",1491.72995494161,1,1488.34287802525,1,1500,0,1500,0,1500,0,1500,0,1491.52448276043,1,1500,0,0,0,0,1,0,-0.330801802335666
"Jones G.D.",1480.55399840802,2,1473.83939105075,2,1500,0,1500,0,1500,0,1500,0,1481.31148483131,2,1500,0,0,0,0,2,0,-0.777840063679392
"Bourgeois L.",1485.71943021242,2,1484.06550156906,2,1500,0,1500,0,1500,0,1500,0,1484.76052186386,2,1500,0,0,0,0,2,0,-0.57122279150309
"March O.",1485.99016592424,1,1486.65236473792,1,1500,0,1500,0,1500,0,1500,0,1500,0,1487.08084855905,1,1,0,-0.560393363030266,0,0,0
"Nunez E.",1488.36064893681,1,1487.47560453229,1,1500,0,1500,0,1500,0,1500,0,1489.14631225658,1,1500,0,0,0,0,1,0,-0.465574042527595
"Parada F.",1484.25740609243,2,1500,0,1500,0,1486.812955076,2,1500,0,1485.41399570792,2,1485.33405113268,2,1500,0,0,0,0,2,0,-0.62970375630271
"Harboe P.",1489.45037504393,1,1500,0,1500,0,1489.88435048754,1,1500,0,1489.93271923601,1,1489.26242927269,1,1500,0,0,0,0,1,0,-0.421984998242785
"Dailey Z.",1490.11420705272,1,1489.30926523956,1,1500,0,1500,0,1500,0,1500,0,1489.78950962702,1,1500,0,0,0,0,1,0,-0.395431717891045
"Minar J.",1486.59200937073,3,1483.07411956498,3,1500,0,1500,0,1500,0,1500,0,1490.03941487896,2,1485.88490808646,1,1,0,-0.18420334599185,2,0,-0.352116279179
"Tecau H.",1487.9785432537,1,1488.2404794896,1,1500,0,1500,0,1500,0,1500,0,1487.41186963734,1,1500,0,0,0,0,1,0,-0.480858269852087
"Condor F.",1486.59553243504,1,1500,0,1500,0,1483.05865205699,1,1500,0,1483.55203452727,1,1487.05803504203,1,1500,0,0,0,0,1,0,-0.536178702598523
"Mirnegg M.",1491.77825115238,1,1500,0,1500,0,1488.93634475818,1,1500,0,1490.07058114057,1,1490.89935263025,1,1500,0,0,0,0,1,0,-0.328869953904702
"Uebel L.",1496.83361175871,1,1500,0,1487.81856465441,1,1500,0,1500,0,1497.24228216399,1,1496.97452515436,1,1500,0,0,0,0,1,0,-0.126655529651648
"Klein T.",1488.85534310841,1,1500,0,1487.68997910794,1,1500,0,1500,0,1488.26069808912,1,1488.85413870599,1,1500,0,0,0,0,1,0,-0.445786275663621
"Korteling S.",1490.49785684347,1,1500,0,1500,0,1490.95693038247,1,1500,0,1489.71459381189,1,1488.26390074377,1,1500,0,0,0,0,1,0,-0.38008572626106
"Thron A.",1475.86627633909,2,1483.98062637652,1,1500,0,1493.64555969381,1,1500,0,1492.7918075831,1,1476.26858724471,2,1500,0,0,0,0,2,0,-0.965348946436416
"Simmonds P.",1479.99203455713,3,1473.42710968944,3,1500,0,1500,0,1500,0,1500,0,1483.38720939547,2,1488.4158168492,1,1,0,-0.163822600399161,2,0,-0.636496017315653
"Clayton A.",1485.79382530701,1,1486.21788239625,1,1500,0,1500,0,1500,0,1500,0,1485.42246847189,1,1500,0,0,0,0,1,0,-0.56824698771941
"Bester P.",1463.81240487933,5,1463.04249294634,5,1500,0,1500,0,1500,0,1500,0,1463.10609375216,5,1500,0,0,0,0,5,0,-1.44750380482697
"Steckley R.",1487.22026375826,1,1487.79641373377,1,1500,0,1500,0,1500,0,1500,0,1487.81482045728,1,1500,0,0,0,0,1,0,-0.511189449669737
"Fruttero J.P.",1488.17454713586,1,1487.33230320493,1,1500,0,1500,0,1500,0,1500,0,1488.13040771088,1,1500,0,0,0,0,1,0,-0.473018114565628
"Chen T.",1474.70733176993,3,1474.28178513524,3,1500,0,1500,0,1500,0,1500,0,1474.09078424113,3,1500,0,0,0,0,3,0,-1.01170672920265
"Do M.Q.",1485.58203778673,1,1487.25239616703,1,1500,0,1500,0,1500,0,1500,0,1485.22182833713,1,1500,0,0,0,0,1,0,-0.576718488530723
"Sanchez de Luna J.A.",1492.71586328618,1,1500,0,1500,0,1490.33267624796,1,1500,0,1489.55405203665,1,1492.83530360743,1,1500,0,0,0,0,1,0,-0.291365468552622
"Ittogi T.",1488.07474751492,1,1487.82272873821,1,1500,0,1500,0,1500,0,1500,0,1488.02985243648,1,1500,0,0,0,0,1,0,-0.477010099403361
"Kirillov E.",1484.12249022794,2,1500,0,1486.25601173249,1,1500,0,1489.02137891318,1,1479.68878358799,2,1482.9368964535,2,1500,0,0,0,0,2,0,-0.635100390882517
"Junaid R.",1481.74513547908,2,1493.56859526971,1,1487.41193867142,1,1500,0,1500,0,1487.64465787487,1,1481.62877769888,2,1500,0,0,0,0,2,0,-0.730194580836829
"Uppal V.",1485.09556822603,1,1485.5224693631,1,1500,0,1500,0,1500,0,1500,0,1485.52869450171,1,1500,0,0,0,0,1,0,-0.596177270958651
"Sultan-Khalfan A.",1490.40111603464,1,1488.78785102645,1,1500,0,1500,0,1500,0,1500,0,1489.78397938601,1,1500,0,0,0,0,1,0,-0.383955358614405
"King-Turner D.",1445.22708522135,6,1436.27340277468,6,1500,0,1500,0,1500,0,1500,0,1442.0375941938,6,1500,0,0,0,0,6,0,-2.19091659114583
"Adaktusson J.",1490.67994775021,1,1489.47809272088,1,1500,0,1500,0,1500,0,1500,0,1500,0,1485.52356023781,1,1,0,-0.372802089991598,0,0,0
"Van der Dium A.",1483.79884474953,1,1484.84373264655,1,1500,0,1500,0,1500,0,1500,0,1483.47431070885,1,1500,0,0,0,0,1,0,-0.648046210018604
"Granollers-Pujol M.",1491.91892351269,1,1500,0,1500,0,1486.50670364122,1,1500,0,1488.28265997067,1,1491.67972443491,1,1500,0,0,0,0,1,0,-0.323243059492364
"Salva B.",1444.43214674593,5,1474.31008108761,2,1500,0,1468.21356907437,3,1500,0,1465.91790937304,3,1444.66466321345,5,1500,0,0,0,0,5,0,-2.22271413016288
"Skoch D.",1470.54539020403,3,1490.24567897949,1,1500,0,1479.6987671465,2,1500,0,1479.08147755177,2,1470.30010109946,3,1500,0,0,0,0,3,0,-1.17818439183869
"Peric T.",1489.50115198673,1,1500,0,1500,0,1489.99151170836,1,1500,0,1488.73952248327,1,1489.16604304202,1,1500,0,0,0,0,1,0,-0.419953920530774
"Luque D.",1487.5,1,1500,0,1500,0,1487.5,1,1500,0,1487.5,1,1487.5,1,1500,0,0,0,0,1,0,-0.5
"Azzaro L.",1470.68671999695,3,1500,0,1500,0,1468.95372870607,3,1500,0,1468.65044436103,3,1469.40728034233,3,1500,0,0,0,0,3,0,-1.17253120012193
"Popp T.",1479.69693298216,2,1500,0,1500,0,1478.73318885729,2,1500,0,1478.60617081214,2,1480.41552055818,2,1500,0,0,0,0,2,0,-0.812122680713545
"Dorsch B.",1472.3097220357,3,1479.79887311483,2,1489.23252663341,1,1500,0,1500,0,1489.86476629586,1,1479.52312775167,2,1491.41176451906,1,1,0,-0.337226492343083,2,0,-0.770384626228922
"Roshardt R.",1476.93279313497,2,1500,0,1500,0,1478.03431407365,2,1500,0,1476.61336828699,2,1476.22600964466,2,1500,0,0,0,0,2,0,-0.922688274601081
"Vicente M.",1487.89360944645,1,1500,0,1500,0,1488.25519785075,1,1500,0,1485.9055260083,1,1488.47291207583,1,1500,0,0,0,0,1,0,-0.48425562214202
"Kutac R.",1487.35172758811,1,1500,0,1500,0,1487.9627921953,1,1500,0,1486.82864335124,1,1487.91416415169,1,1500,0,0,0,0,1,0,-0.505930896475576
"Patriarca D.",1487.5,1,1500,0,1500,0,1487.5,1,1500,0,1487.5,1,1487.5,1,1500,0,0,0,0,1,0,-0.5
"Sandbichler A.",1487.87993791355,1,1500,0,1500,0,1487.71129349899,1,1500,0,1488.03910916198,1,1487.83345924018,1,1500,0,0,0,0,1,0,-0.484802483457807
"Belic L.",1470.82150755633,3,1500,0,1500,0,1466.39976786496,3,1500,0,1468.46705758924,3,1467.48493589429,3,1500,0,0,0,0,3,0,-1.16713969774691
"Panfil G.",1485.917191381,1,1500,0,1500,0,1486.64451265735,1,1500,0,1486.00428825309,1,1485.41201335212,1,1500,0,0,0,0,1,0,-0.563312344760065
"Dev Varman S.",1464.03910617564,3,1466.22424000466,3,1500,0,1500,0,1500,0,1500,0,1464.89111877472,3,1500,0,0,0,0,3,0,-1.43843575297428
"Yu X.Y.",1470.91306983445,2,1471.86785297638,2,1500,0,1500,0,1500,0,1500,0,1470.75339200967,2,1500,0,0,0,0,2,0,-1.16347720662185
"Wang Y.Jr.",1487.05047029068,1,1487.05047029068,1,1500,0,1500,0,1500,0,1500,0,1487.05047029068,1,1500,0,0,0,0,1,0,-0.517981188372765
"Dolgopolov A.",1477.13645288708,2,1500,0,1500,0,1478.6893047734,2,1500,0,1476.07459696756,2,1477.96522516456,2,1500,0,0,0,0,2,0,-0.914541884516688
"Aranguren J.M.",1477.25549450683,2,1500,0,1500,0,1474.78967179698,2,1500,0,1474.80191427619,2,1477.23275687875,2,1500,0,0,0,0,2,0,-0.909780219726759
"Smit J.",1485.00511539002,1,1485.01524029539,1,1500,0,1500,0,1500,0,1500,0,1485.40157051179,1,1500,0,0,0,0,1,0,-0.599795384399271
"Wagh A.",1493.47750318859,1,1492.75215605887,1,1500,0,1500,0,1500,0,1500,0,1492.12758427842,1,1500,0,0,0,0,1,0,-0.260899872456224
"Chaen T.",1485.297639596,1,1484.66624330778,1,1500,0,1500,0,1500,0,1500,0,1485.65412344366,1,1500,0,0,0,0,1,0,-0.588094416160183
"Schuttler P.",1486.13639369161,1,1500,0,1500,0,1500,0,1487.86574194523,1,1486.78426035036,1,1485.97086612607,1,1500,0,0,0,0,1,0,-0.554544252335725
"Fish A.",1491.74764188873,1,1492.71082223354,1,1500,0,1500,0,1500,0,1500,0,1491.82836584691,1,1500,0,0,0,0,1,0,-0.330094324450722
"Jun W.",1492.94236411903,1,1491.40785632153,1,1500,0,1500,0,1500,0,1500,0,1492.92541613237,1,1500,0,0,0,0,1,0,-0.282305435238775
"Echagaray B.",1469.19395370652,4,1492.69207043016,1,1500,0,1478.42342861567,3,1500,0,1476.37592201717,3,1476.07382733449,3,1488.61274310235,1,1,0,-0.278457986354739,3,0,-0.953783865384638
"Fornell M.",1484.67309978066,1,1500,0,1500,0,1484.73682318102,1,1500,0,1484.39333790349,1,1484.80154395636,1,1500,0,0,0,0,1,0,-0.613076008773681
"Dustov F.",1448.49698274653,7,1500,0,1478.02824283683,2,1453.42862492654,5,1500,0,1441.30217472207,7,1446.76394050968,7,1500,0,0,0,0,7,0,-2.06012069013883
"Chaki R.",1481.40267489787,2,1500,0,1500,0,1481.0278527339,2,1500,0,1480.33352525011,2,1480.99396142918,2,1500,0,0,0,0,2,0,-0.743893004085258
"Sousa P.",1454.53856046497,5,1500,0,1500,0,1450.15572324346,5,1500,0,1453.50748645961,5,1452.79674093864,5,1500,0,0,0,0,5,0,-1.81845758140133
"Eysseric J.",1470.52604707878,3,1500,0,1500,0,1464.38505050291,3,1500,0,1467.85273906652,3,1487.15220972862,1,1476.46601978665,2,2,0,-0.69237344361114,1,0,-0.486584673237614
"Nielsen F.",1402.50918471133,10,1432.08710042067,6,1463.2989389956,3,1492.4107229268,1,1500,0,1457.93900660592,4,1404.12134654219,9,1487.10686355749,1,1,0,-0.163651634112577,9,0,-3.73598097743429
"Koning M.",1495.82289461063,1,1500,0,1488.99006206777,1,1500,0,1500,0,1495.07570366009,1,1494.73222820292,1,1500,0,0,0,0,1,0,-0.167084215574714
"Guzman J.",1488.17168526217,1,1500,0,1487.24830675123,1,1500,0,1500,0,1488.0728645182,1,1500,0,1488.8102473203,1,1,0,-0.473132589513384,0,0,0
"Goransson T.",1472.97450318688,2,1500,0,1500,0,1472.84043814083,2,1500,0,1472.44603017672,2,1473.35368418699,2,1500,0,0,0,0,2,0,-1.08101987252472
"Tveit E.",1491.58646330358,1,1500,0,1500,0,1492.42607010626,1,1500,0,1491.7839944748,1,1489.29527655386,1,1500,0,0,0,0,1,0,-0.336541467856776
"Ruevski P.",1487.25472577198,1,1500,0,1500,0,1487.14846378237,1,1500,0,1487.10945666092,1,1487.24706982373,1,1500,0,0,0,0,1,0,-0.509810969120759
"Olejniczak D.",1470.92894236237,3,1500,0,1487.87321735386,1,1480.95119710382,2,1500,0,1472.05126227508,3,1476.9414471737,2,1487.35173316988,1,1,0,-0.248503211309474,2,0,-0.914339094195754
"McClune M.",1493.71297866821,1,1492.94311180425,1,1500,0,1500,0,1500,0,1500,0,1500,0,1488.62758692637,1,1,0,-0.251480853271767,0,0,0
"Gard C.",1489.57977727566,1,1500,0,1500,0,1487.61536570141,1,1500,0,1488.93571916084,1,1489.74183521691,1,1500,0,0,0,0,1,0,-0.416808908973792
"Martin D.",1494.36086601833,1,1491.76539085476,1,1500,0,1500,0,1500,0,1500,0,1492.77917561604,1,1500,0,0,0,0,1,0,-0.225565359266846
"Wachiramanowong K.",1484.06015403733,3,1477.30184674239,3,1500,0,1500,0,1500,0,1500,0,1481.30049392149,3,1500,0,0,0,0,3,0,-0.637593838506625
"Siriluethaiwattana P.",1479.30867025978,2,1476.87474328669,2,1500,0,1500,0,1500,0,1500,0,1479.37739194398,2,1500,0,0,0,0,2,0,-0.827653189608772
"Singh N.",1487.82514906497,1,1487.69540757581,1,1500,0,1500,0,1500,0,1500,0,1487.81893945172,1,1500,0,0,0,0,1,0,-0.486994037401303
"Raja P.",1487.33556639671,1,1486.39500660787,1,1500,0,1500,0,1500,0,1500,0,1487.71405888461,1,1500,0,0,0,0,1,0,-0.50657734413165
"Nam H.W.",1471.59166710079,2,1472.76350156946,2,1500,0,1500,0,1500,0,1500,0,1472.00296280993,2,1500,0,0,0,0,2,0,-1.13633331596839
"Chekov P.",1485.22463827478,1,1500,0,1500,0,1500,0,1486.90269178927,1,1485.72385132773,1,1484.80168253241,1,1500,0,0,0,0,1,0,-0.591014469008992
"Vardhan V.",1480.6744315754,2,1478.6984194319,2,1500,0,1500,0,1500,0,1500,0,1479.7551659602,2,1500,0,0,0,0,2,0,-0.773022736983845
"Haji A.",1489.59137080858,1,1487.87648894653,1,1500,0,1500,0,1500,0,1500,0,1489.5779392019,1,1500,0,0,0,0,1,0,-0.416345167656806
"Statham R.",1489.34568729788,1,1483.89784229254,1,1500,0,1500,0,1500,0,1500,0,1489.28661141473,1,1500,0,0,0,0,1,0,-0.426172508084883
"Podlipnik H.",1485.15766474334,2,1500,0,1500,0,1485.57949987605,2,1500,0,1484.30754672111,2,1484.43630993018,2,1500,0,0,0,0,2,0,-0.593693410266294
"Munoz de la Nava D.",1490.36378915454,1,1500,0,1500,0,1493.47344321343,1,1500,0,1492.6137810177,1,1490.80268196775,1,1500,0,0,0,0,1,0,-0.385448433818346
"Bowles C.",1488.50906991005,1,1488.29933064852,1,1500,0,1500,0,1500,0,1500,0,1487.57767174916,1,1500,0,0,0,0,1,0,-0.459637203598163
"Crugnola M.",1485.16065773523,3,1486.32114706832,2,1500,0,1494.52045917511,1,1500,0,1494.44411969272,1,1487.82417193438,2,1495.12438908426,1,1,0,-0.155314036897616,2,0,-0.438259653693379
"Rodriguez B.",1487.0379193493,1,1500,0,1500,0,1487.68115298131,1,1500,0,1487.27837106416,1,1487.75682437522,1,1500,0,0,0,0,1,0,-0.518483226027831
"Ramirez C.",1476.20357948733,3,1500,0,1500,0,1479.30888848929,3,1500,0,1477.93204229245,3,1475.12917194561,3,1500,0,0,0,0,3,0,-0.951856820506734
"Al-Ghareeb M.",1496.25443376847,1,1495.40026095966,1,1500,0,1500,0,1500,0,1500,0,1494.91133022437,1,1500,0,0,0,0,1,0,-0.149822649261133
"Nader M.",1486.59845684193,1,1487.15770405953,1,1500,0,1500,0,1500,0,1500,0,1486.64697539654,1,1500,0,0,0,0,1,0,-0.536061726322776
"Sanchez De Luna J.",1487.27621076315,2,1500,0,1500,0,1484.45138567939,2,1500,0,1483.49083461813,2,1486.48698826867,2,1500,0,0,0,0,2,0,-0.508951569473973
"Marrai M.",1488.12709480786,1,1500,0,1500,0,1490.73132671188,1,1500,0,1489.7681605686,1,1488.09367008669,1,1500,0,0,0,0,1,0,-0.474916207685594
"Lipsky S.",1485.10631625631,1,1500,0,1487.81234042519,1,1500,0,1500,0,1487.31958320881,1,1485.37329179546,1,1500,0,0,0,0,1,0,-0.59574734974772
"Middelkoop M.",1489.79952736394,1,1500,0,1486.78578556259,1,1500,0,1500,0,1489.80436004769,1,1489.1520046647,1,1500,0,0,0,0,1,0,-0.408018905442312
"Slabinsky A.",1481.51346170671,2,1500,0,1474.72630173157,2,1500,0,1500,0,1474.52602610823,2,1480.95430204163,2,1500,0,0,0,0,2,0,-0.739461531731737
"Kim K",1496.05094138725,1,1500,0,1489.8534301547,1,1500,0,1500,0,1493.20696346994,1,1500,0,1487.76784279657,1,1,0,-0.157962344509961,0,0,0
"Brizzi A.",1486.13242405362,1,1500,0,1500,0,1486.6777383735,1,1500,0,1486.38216630422,1,1485.89300220994,1,1500,0,0,0,0,1,0,-0.554703037855314
"O'Neal J.",1484.55861437078,1,1485.09134822769,1,1500,0,1500,0,1500,0,1500,0,1485.64740513248,1,1500,0,0,0,0,1,0,-0.617655425168713
"Piccari F.",1484.94705087477,1,1500,0,1500,0,1485.64360283238,1,1500,0,1486.20826360322,1,1485.30309021844,1,1500,0,0,0,0,1,0,-0.602117965009151
"Estrella V.",1496.00723923654,1,1491.83708957722,1,1500,0,1500,0,1500,0,1500,0,1494.94698597477,1,1500,0,0,0,0,1,0,-0.159710430538387
"Ignatik U.",1490.32006761086,1,1489.7957574298,1,1500,0,1500,0,1500,0,1500,0,1489.54411790687,1,1500,0,0,0,0,1,0,-0.387197295565689
"Djokovic M.",1456.23774189341,4,1478.5792275116,2,1500,0,1476.88217876128,2,1500,0,1476.42714419973,2,1455.24192144689,4,1500,0,0,0,0,4,0,-1.75049032426363
"Xu J.C.",1485.72279802838,1,1486.15247911941,1,1500,0,1500,0,1500,0,1500,0,1486.52786775194,1,1500,0,0,0,0,1,0,-0.571088078864775
"Ito Y.",1487.28442662316,1,1487.38149305914,1,1500,0,1500,0,1500,0,1500,0,1487.58010429203,1,1500,0,0,0,0,1,0,-0.508622935073537
"Hajji A.",1477.63603639529,2,1477.56020143165,2,1500,0,1500,0,1500,0,1500,0,1477.46540240234,2,1500,0,0,0,0,2,0,-0.894558544188514
"Ebelthite C.",1487.53268579713,1,1487.65036415981,1,1500,0,1500,0,1500,0,1500,0,1500,0,1487.65777111596,1,1,0,-0.498692568114864,0,0,0
"Anderson A.",1494.97732628616,1,1493.10141754272,1,1500,0,1500,0,1500,0,1500,0,1493.86996251495,1,1500,0,0,0,0,1,0,-0.200906948553607
"Hutchins R.",1487.94305113183,1,1487.16046836269,1,1500,0,1500,0,1500,0,1500,0,1488.52881660781,1,1500,0,0,0,0,1,0,-0.482277954726857
"Hocevar R.",1449.24910989857,5,1494.09735148564,1,1500,0,1456.79564662302,4,1500,0,1454.58754054008,4,1453.68968474319,4,1495.94794165212,1,1,0,-0.136421594145338,4,0,-1.89361400991175
"Silva D.",1485.82153716065,1,1500,0,1500,0,1487.3155513904,1,1500,0,1486.46565683941,1,1485.84620332858,1,1500,0,0,0,0,1,0,-0.567138513574048
"Poerschke L.",1484.75157996807,2,1483.64391626906,2,1500,0,1500,0,1500,0,1500,0,1483.18487720829,2,1500,0,0,0,0,2,0,-0.609936801277218
"Munoz de La Nava D.",1493.05603497954,1,1500,0,1500,0,1493.64106901459,1,1500,0,1492.72802668778,1,1492.9912212374,1,1500,0,0,0,0,1,0,-0.277758600818233
"King E.",1488.66426263872,1,1486.18727195802,1,1500,0,1500,0,1500,0,1500,0,1488.6032198124,1,1500,0,0,0,0,1,0,-0.453429494451084
"Riba-Madrid P.",1474.88784301193,2,1500,0,1484.87468601074,1,1487.86840554088,1,1500,0,1469.53752468518,2,1487.84047652019,1,1484.65446986258,1,1,0,-0.521650630513113,1,0,-0.482835649009673
"Zlatanovic A.",1486.27926370678,1,1500,0,1500,0,1486.46749040899,1,1500,0,1485.65387830392,1,1485.46864189033,1,1500,0,0,0,0,1,0,-0.548829451728856
"Kloer S.",1494.43700213101,1,1500,0,1500,0,1492.38853730251,1,1500,0,1493.97698876802,1,1493.76880478912,1,1500,0,0,0,0,1,0,-0.222519914759592
"Fleming C.",1482.1553344706,2,1500,0,1477.34985559237,2,1500,0,1500,0,1478.62628329985,2,1482.08767030121,2,1500,0,0,0,0,2,0,-0.713786621176119
"Berta D.",1471.67516198898,2,1500,0,1486.51856773275,1,1486.20791745562,1,1500,0,1469.03992041426,2,1472.04083584502,2,1500,0,0,0,0,2,0,-1.13299352044096
"Ghedin R.",1471.17963999303,3,1487.90931802794,1,1477.5058493606,2,1500,0,1500,0,1478.7790409388,2,1479.59874208264,2,1490.12730911871,1,1,0,-0.37095401294476,2,0,-0.781860387333941
"Krawietz K.",1474.91202931896,3,1500,0,1500,0,1467.31445743058,3,1500,0,1470.11665331082,3,1475.16482992726,3,1500,0,0,0,0,3,0,-1.00351882724155
"Britton D.",1483.60287063214,3,1479.12907913421,3,1500,0,1500,0,1500,0,1500,0,1483.30327999222,2,1499.13299900515,1,1,0,-0.0212579126817903,2,0,-0.634627262032574
"Agostinelli B.",1485.30500188545,1,1485.84881688823,1,1500,0,1500,0,1500,0,1500,0,1485.77792873943,1,1500,0,0,0,0,1,0,-0.587799924582052
"Buchanan C.",1487.50845238135,2,1486.88566024955,2,1500,0,1500,0,1500,0,1500,0,1490.32601054481,1,1492.66695189652,1,1,0,-0.12996969238345,1,0,-0.369692212362668
"Luncanu P.A.",1482.09525917476,2,1490.45624812181,1,1500,0,1487.24391095968,1,1500,0,1487.636218806,1,1481.14943828754,2,1500,0,0,0,0,2,0,-0.716189633009741
"Valent R.",1491.18378624793,1,1489.4783982188,1,1500,0,1500,0,1500,0,1500,0,1489.9139143801,1,1500,0,0,0,0,1,0,-0.352648550082612
"Gong M.X.",1477.35969765257,4,1474.28663882059,4,1500,0,1500,0,1500,0,1500,0,1474.18532849501,4,1500,0,0,0,0,4,0,-0.905612093897032
"Biryukov M.",1479.40140217366,2,1473.54423643682,2,1500,0,1500,0,1500,0,1500,0,1480.24425114808,2,1500,0,0,0,0,2,0,-0.823943913053757
"Vovk S.",1487.6137806799,1,1487.97991633598,1,1500,0,1500,0,1500,0,1500,0,1487.98860532393,1,1500,0,0,0,0,1,0,-0.495448772803936
"Karlovic I. ",1487.5,1,1487.5,1,1500,0,1500,0,1500,0,1500,0,1487.5,1,1500,0,0,0,0,1,0,-0.5
"Bohli S. ",1487.5,1,1487.5,1,1500,0,1500,0,1500,0,1500,0,1487.5,1,1500,0,0,0,0,1,0,-0.5
"Rochus O. ",1487.5,1,1487.5,1,1500,0,1500,0,1500,0,1500,0,1487.5,1,1500,0,0,0,0,1,0,-0.5
"Schuettler R. ",1487.5,1,1487.5,1,1500,0,1500,0,1500,0,1500,0,1487.5,1,1500,0,0,0,0,1,0,-0.5
"Luczak P. ",1487.5,1,1487.5,1,1500,0,1500,0,1500,0,1500,0,1487.5,1,1500,0,0,0,0,1,0,-0.5
"Kohlschreiber P. ",1487.5,1,1487.5,1,1500,0,1500,0,1500,0,1500,0,1487.5,1,1500,0,0,0,0,1,0,-0.5
"Bolelli S. ",1487.5,1,1487.5,1,1500,0,1500,0,1500,0,1500,0,1487.5,1,1500,0,0,0,0,1,0,-0.5
"Becker B. ",1487.5,1,1487.5,1,1500,0,1500,0,1500,0,1500,0,1487.5,1,1500,0,0,0,0,1,0,-0.5
"Beck A. ",1487.5,1,1487.5,1,1500,0,1500,0,1500,0,1500,0,1487.5,1,1500,0,0,0,0,1,0,-0.5
"Benneteau J. ",1487.5,1,1487.5,1,1500,0,1500,0,1500,0,1500,0,1487.5,1,1500,0,0,0,0,1,0,-0.5
"Koellerer D. ",1487.5,1,1487.5,1,1500,0,1500,0,1500,0,1500,0,1487.5,1,1500,0,0,0,0,1,0,-0.5
"Petzschner P. ",1487.5,1,1487.5,1,1500,0,1500,0,1500,0,1500,0,1487.5,1,1500,0,0,0,0,1,0,-0.5
"Zeballos H. ",1487.5,1,1487.5,1,1500,0,1500,0,1500,0,1500,0,1487.5,1,1500,0,0,0,0,1,0,-0.5
"Blake J. ",1487.5,1,1487.5,1,1500,0,1500,0,1500,0,1500,0,1487.5,1,1500,0,0,0,0,1,0,-0.5
"Ljubicic I. ",1487.5,1,1487.5,1,1500,0,1500,0,1500,0,1500,0,1487.5,1,1500,0,0,0,0,1,0,-0.5
"Gonzalez F. ",1487.5,1,1487.5,1,1500,0,1500,0,1500,0,1500,0,1487.5,1,1500,0,0,0,0,1,0,-0.5
"Bautista R. ",1487.5,1,1487.5,1,1500,0,1500,0,1500,0,1500,0,1487.5,1,1500,0,0,0,0,1,0,-0.5
"Mathieu P.H. ",1487.5,1,1487.5,1,1500,0,1500,0,1500,0,1500,0,1487.5,1,1500,0,0,0,0,1,0,-0.5
"Greul S. ",1487.5,1,1487.5,1,1500,0,1500,0,1500,0,1500,0,1487.5,1,1500,0,0,0,0,1,0,-0.5
"Falla A. ",1487.5,1,1487.5,1,1500,0,1500,0,1500,0,1500,0,1487.5,1,1500,0,0,0,0,1,0,-0.5
"Kunitsyn I. ",1487.5,1,1487.5,1,1500,0,1500,0,1500,0,1500,0,1487.5,1,1500,0,0,0,0,1,0,-0.5
"Granollers M. ",1487.5,1,1487.5,1,1500,0,1500,0,1500,0,1500,0,1487.5,1,1500,0,0,0,0,1,0,-0.5
"Vassallo-Arguello M. ",1487.5,1,1487.5,1,1500,0,1500,0,1500,0,1500,0,1487.5,1,1500,0,0,0,0,1,0,-0.5
"Almagro N. ",1487.5,1,1487.5,1,1500,0,1500,0,1500,0,1500,0,1487.5,1,1500,0,0,0,0,1,0,-0.5
"Andreev I. ",1487.5,1,1487.5,1,1500,0,1500,0,1500,0,1500,0,1487.5,1,1500,0,0,0,0,1,0,-0.5
"Ferrero J.C. ",1487.5,1,1487.5,1,1500,0,1500,0,1500,0,1500,0,1487.5,1,1500,0,0,0,0,1,0,-0.5
"Gimeno-Traver D. ",1487.5,1,1487.5,1,1500,0,1500,0,1500,0,1500,0,1487.5,1,1500,0,0,0,0,1,0,-0.5
"Rochus C. ",1487.5,1,1487.5,1,1500,0,1500,0,1500,0,1500,0,1487.5,1,1500,0,0,0,0,1,0,-0.5
"Tsonga J.W. ",1487.5,1,1487.5,1,1500,0,1500,0,1500,0,1500,0,1487.5,1,1500,0,0,0,0,1,0,-0.5
"Hanescu V. ",1487.5,1,1487.5,1,1500,0,1500,0,1500,0,1500,0,1487.5,1,1500,0,0,0,0,1,0,-0.5
"Martin A. ",1487.5,1,1487.5,1,1500,0,1500,0,1500,0,1500,0,1487.5,1,1500,0,0,0,0,1,0,-0.5
"Hernandez O. ",1487.5,1,1487.5,1,1500,0,1500,0,1500,0,1500,0,1487.5,1,1500,0,0,0,0,1,0,-0.5
"Yang T.H.",1474.46103812422,4,1467.63635102022,4,1500,0,1500,0,1500,0,1500,0,1472.74787626039,4,1500,0,0,0,0,4,0,-1.02155847503115
"Maamoun K.",1489.27213267929,1,1487.56921875904,1,1500,0,1500,0,1500,0,1500,0,1488.77999540141,1,1500,0,0,0,0,1,0,-0.429114692828476
"Lemke J.",1492.82122046121,1,1484.83084912996,1,1500,0,1500,0,1500,0,1500,0,1492.95012885161,1,1500,0,0,0,0,1,0,-0.287151181551578
"Saavedra Corvalan C.",1486.830036508,1,1500,0,1500,0,1486.77082160333,1,1500,0,1485.46213364048,1,1486.91438942578,1,1500,0,0,0,0,1,0,-0.526798539680106
"Im K.T.",1486.75603954707,1,1487.01494519623,1,1500,0,1500,0,1500,0,1500,0,1486.67805362182,1,1500,0,0,0,0,1,0,-0.529758418117216
"Deheart R.",1486.26712316335,2,1485.49780957201,2,1500,0,1500,0,1500,0,1500,0,1485.95163293406,2,1500,0,0,0,0,2,0,-0.549315073465955
"Niland C.",1479.60246010755,3,1499.28037667847,1,1487.72473769939,1,1487.34699815186,1,1500,0,1474.885789505,2,1490.05324362977,1,1484.92571765051,2,2,0,-0.430468805559048,1,0,-0.385432790139132
"Emmrich M.",1492.56203069525,1,1500,0,1490.34902344951,1,1500,0,1500,0,1490.17092193874,1,1492.70038244001,1,1500,0,0,0,0,1,0,-0.297518772189838
"Alcaide G.",1494.53552135856,1,1500,0,1489.62077253125,1,1500,0,1500,0,1492.52048952412,1,1500,0,1491.04059207813,1,1,0,-0.218579145657493,0,0,0
"Velotti A.",1474.12600522813,3,1500,0,1500,0,1473.0680795694,3,1500,0,1472.83492950059,3,1474.26113312218,3,1500,0,0,0,0,3,0,-1.03495979087469
"Lojda D.",1492.40375236188,1,1489.7330004535,1,1500,0,1500,0,1500,0,1500,0,1500,0,1489.18282798469,1,1,0,-0.303849905524616,0,0,0
"Si Y.M.",1486.97240584936,1,1487.01648636601,1,1500,0,1500,0,1500,0,1500,0,1486.96908252654,1,1500,0,0,0,0,1,0,-0.521103766025657
"Belyaev I.",1491.25251842788,1,1489.24823641815,1,1500,0,1500,0,1500,0,1500,0,1490.42584650723,1,1500,0,0,0,0,1,0,-0.349899262884991
"Muster T.",1470.79134644538,3,1474.71435368336,2,1500,0,1492.34844589961,1,1500,0,1494.57141235003,1,1470.96844346495,3,1500,0,0,0,0,3,0,-1.16834614218475
"Sabry S.",1487.80342524527,1,1487.53569960122,1,1500,0,1500,0,1500,0,1500,0,1487.41026291227,1,1500,0,0,0,0,1,0,-0.487862990189334
"Scholtz N.",1485.34990089444,1,1485.02168035855,1,1500,0,1500,0,1500,0,1500,0,1485.93783655215,1,1500,0,0,0,0,1,0,-0.586003964222577
"Rios F.",1487.0118241619,1,1500,0,1500,0,1488.06546504113,1,1500,0,1487.99322255201,1,1487.28478081642,1,1500,0,0,0,0,1,0,-0.519527033523846
"Romboli F.",1484.68287513984,1,1500,0,1500,0,1487.01618726314,1,1500,0,1486.18863504316,1,1485.72070926076,1,1500,0,0,0,0,1,0,-0.612684994406393
"Clezar G.",1415.76085278892,9,1485.79280619342,1,1500,0,1429.51345997842,8,1500,0,1428.15990349134,8,1426.62644125498,8,1487.7791688128,1,1,0,-0.421322196533037,8,0,-2.94824369191011
"Borvanov R.",1490.24601847556,1,1488.37598405383,1,1500,0,1500,0,1500,0,1500,0,1489.47830091347,1,1500,0,0,0,0,1,0,-0.390159260977674
"Galdon P.",1496.26042580393,1,1500,0,1500,0,1496.58303311372,1,1500,0,1496.37779274406,1,1495.34736485926,1,1500,0,0,0,0,1,0,-0.149582967842684
"Kumantsov A.",1476.50801557451,2,1474.90894420056,2,1500,0,1500,0,1500,0,1500,0,1476.79995862255,2,1500,0,0,0,0,2,0,-0.939679377019729
"Garza D.",1462.08406129006,4,1493.24828132807,1,1500,0,1465.86542076655,3,1500,0,1466.06712370779,3,1460.20465417263,4,1500,0,0,0,0,4,0,-1.51663754839746
"Sanchez M.",1485.67870939828,1,1500,0,1500,0,1486.05872988523,1,1500,0,1486.15790415524,1,1485.84494710344,1,1500,0,0,0,0,1,0,-0.572851624068885
"Awadhy O.",1481.96915100415,2,1480.76760900013,2,1500,0,1500,0,1500,0,1500,0,1481.61715375054,2,1500,0,0,0,0,2,0,-0.72123395983406
"Granollers Pujol G.",1488.83911596752,1,1500,0,1500,0,1489.31867018453,1,1500,0,1489.31178460292,1,1488.45528914304,1,1500,0,0,0,0,1,0,-0.446435361299253
"Granollers-Pujol G.",1480.62541261202,2,1500,0,1500,0,1482.20821500649,2,1500,0,1481.77291070388,2,1480.93734066416,2,1500,0,0,0,0,2,0,-0.774983495519217
"Cox D.",1448.88091528674,5,1500,0,1442.41700173364,5,1500,0,1500,0,1445.69407109404,5,1458.85561453685,3,1479.97742622564,2,2,0,-0.476408979961692,3,0,-1.56835440856876
"Golding O.",1465.52851375595,3,1500,0,1462.64914952982,3,1500,0,1500,0,1462.81060788546,3,1475.76679573799,2,1489.68471052308,1,1,0,-0.336780850914184,2,0,-1.04207859884776
"Walter L.",1485.48147616614,1,1500,0,1485.42666876562,1,1500,0,1500,0,1486.0405472897,1,1486.05556985686,1,1500,0,0,0,0,1,0,-0.580740953354381
"Kern R.",1470.39425122374,3,1500,0,1500,0,1470.92901984347,3,1500,0,1470.84163263548,3,1468.40359569809,3,1500,0,0,0,0,3,0,-1.18422995105047
"Grigelis L.",1490.09682765826,1,1487.73990777469,1,1500,0,1500,0,1500,0,1500,0,1488.80044595738,1,1500,0,0,0,0,1,0,-0.39612689366952
"Sitak A.",1484.91181676895,1,1484.43661159839,1,1500,0,1500,0,1500,0,1500,0,1485.28879558129,1,1500,0,0,0,0,1,0,-0.603527329242171
"Chvojka E.",1482.41492101403,2,1493.48364610487,1,1500,0,1489.64819147737,1,1500,0,1488.94016812177,1,1482.01517719447,2,1500,0,0,0,0,2,0,-0.70340315943872
"Torebko P.",1489.61733241304,1,1500,0,1500,0,1488.5250299151,1,1500,0,1488.26119891375,1,1489.27739747964,1,1500,0,0,0,0,1,0,-0.415306703478262
"Li Z.",1463.63027352078,5,1460.30288911996,5,1500,0,1500,0,1500,0,1500,0,1462.1221961432,5,1500,0,0,0,0,5,0,-1.45478905916862
"Nedelko I.",1478.99351131219,2,1474.71470520348,2,1500,0,1500,0,1500,0,1500,0,1478.69857418109,2,1500,0,0,0,0,2,0,-0.840259547512354
"Mitchell B.",1455.23082856863,5,1453.0250677218,5,1500,0,1500,0,1500,0,1500,0,1469.25831224702,3,1479.66508652486,2,2,0,-0.596444453331685,3,0,-1.19432240392296
"Al Mutawa J.",1487.46036933408,1,1487.72674195148,1,1500,0,1500,0,1500,0,1500,0,1486.50694386845,1,1500,0,0,0,0,1,0,-0.501585226636686
"Viola Mat.",1483.52348674327,2,1477.82041816681,2,1500,0,1500,0,1500,0,1500,0,1489.16143750391,1,1485.2091389266,1,1,0,-0.296253844044522,1,0,-0.362806686224873
"Van D. Merwe I.",1485.70284981712,1,1485.7178475425,1,1500,0,1500,0,1500,0,1500,0,1486.17944710547,1,1500,0,0,0,0,1,0,-0.571886007315046
"Mesaros K.",1491.53663706802,1,1488.58359065218,1,1500,0,1500,0,1500,0,1500,0,1490.70752710631,1,1500,0,0,0,0,1,0,-0.338534517279147
"Marcan D.",1484.65866361295,2,1481.16483420297,2,1500,0,1500,0,1500,0,1500,0,1484.10909815805,2,1500,0,0,0,0,2,0,-0.613653455481942
"Lajola D.",1487.5,1,1487.5,1,1500,0,1500,0,1500,0,1500,0,1487.5,1,1500,0,0,0,0,1,0,-0.5
"Strode B.",1487.94952970932,1,1487.94952970932,1,1500,0,1500,0,1500,0,1500,0,1487.94952970932,1,1500,0,0,0,0,1,0,-0.482018811627235
"Molteni A.",1485.77586152748,2,1500,0,1500,0,1485.20840975029,2,1500,0,1485.18523351392,2,1485.66533638645,2,1500,0,0,0,0,2,0,-0.568965538900609
"Cabal J.S.",1476.44850661465,2,1500,0,1500,0,1474.86880727251,2,1500,0,1474.99415411519,2,1476.81035713503,2,1500,0,0,0,0,2,0,-0.942059735413976
"Idmbarek Y.",1480.68135981768,2,1500,0,1500,0,1478.3028533325,2,1500,0,1479.65624321799,2,1479.47611416992,2,1500,0,0,0,0,2,0,-0.772745607292831
"Gomez-Herrera C.",1489.38344309706,1,1500,0,1500,0,1489.49527255038,1,1500,0,1489.23385032199,1,1489.33291935807,1,1500,0,0,0,0,1,0,-0.424662276117405
"Trusendi W.",1486.95634634329,1,1500,0,1500,0,1485.39004406515,1,1500,0,1486.40062640974,1,1486.81882630493,1,1500,0,0,0,0,1,0,-0.521746146268503
"Ehrat S.",1483.74471043657,1,1500,0,1500,0,1484.95403566418,1,1500,0,1484.9150186805,1,1484.08399982947,1,1500,0,0,0,0,1,0,-0.650211582537225
"Meister N.",1492.60229893457,1,1488.27808355432,1,1500,0,1500,0,1500,0,1500,0,1491.43778979931,1,1500,0,0,0,0,1,0,-0.295908042617368
"Authom M.",1476.44574962942,2,1472.63979299823,2,1500,0,1500,0,1500,0,1500,0,1500,0,1468.19970550964,2,2,0,-0.942170014823094,0,0,0
"Vasilevski A.",1487.64727343862,1,1487.89339043685,1,1500,0,1500,0,1500,0,1500,0,1487.44311141772,1,1500,0,0,0,0,1,0,-0.494109062455154
"Betov S.",1485.51901766545,1,1484.75457060138,1,1500,0,1500,0,1500,0,1500,0,1485.9016738854,1,1500,0,0,0,0,1,0,-0.579239293382056
"Fidirko N.",1487.01382030485,1,1485.36251932535,1,1500,0,1500,0,1500,0,1500,0,1487.45009236547,1,1500,0,0,0,0,1,0,-0.519447187806159
"Deen Heshaam A.",1488.12492002902,1,1487.79854682404,1,1500,0,1500,0,1500,0,1500,0,1488.22886749901,1,1500,0,0,0,0,1,0,-0.475003198839036
"Inglot D.",1484.9147128219,2,1477.52509652882,2,1500,0,1500,0,1500,0,1500,0,1485.17862095416,2,1500,0,0,0,0,2,0,-0.603411487123937
"Singh S.",1493.89461421029,1,1494.31631225195,1,1500,0,1500,0,1500,0,1500,0,1494.00910935243,1,1500,0,0,0,0,1,0,-0.244215431588461
"Ali Mutawa J.M.",1477.42882583193,2,1475.68498545777,2,1500,0,1500,0,1500,0,1500,0,1477.01752778505,2,1500,0,0,0,0,2,0,-0.902846966722885
"Zayed M. S.",1496.38989379323,1,1496.25972388632,1,1500,0,1500,0,1500,0,1500,0,1496.30931765485,1,1500,0,0,0,0,1,0,-0.144404248270603
"Veger F.",1490.56213420609,1,1486.77359187059,1,1500,0,1500,0,1500,0,1500,0,1489.21169837332,1,1500,0,0,0,0,1,0,-0.377514631756593
"Reyes-Varela M.A.",1480.76553542741,2,1491.31509183666,1,1500,0,1490.18565140333,1,1500,0,1490.03165882789,1,1478.71468743198,2,1500,0,0,0,0,2,0,-0.76937858290353
"Rachidi Y.",1486.92690681155,1,1500,0,1500,0,1487.16296123018,1,1500,0,1487.14922660329,1,1486.8401265138,1,1500,0,0,0,0,1,0,-0.522923727538027
"Granollers G.",1486.86054241848,1,1500,0,1500,0,1487.33406565292,1,1500,0,1487.32937384484,1,1486.82104504779,1,1500,0,0,0,0,1,0,-0.525578303261001
"Desein N.",1469.28478537622,3,1489.41586246234,1,1486.24078277219,1,1488.70273276721,1,1500,0,1474.00402580879,2,1477.87596298431,2,1488.05559695319,1,1,0,-0.338994205478688,2,0,-0.889614379472685
"Corrie E.",1489.21100055661,1,1500,0,1487.3555602283,1,1500,0,1500,0,1487.05440035352,1,1489.17215581175,1,1500,0,0,0,0,1,0,-0.431559977735597
"Reid M.",1494.15973974063,1,1500,0,1492.22842400452,1,1500,0,1500,0,1492.29486477936,1,1500,0,1490.33624254852,1,1,0,-0.233610410374901,0,0,0
"Eriksson M.",1454.42477155802,4,1485.9235219971,1,1500,0,1468.04394379533,3,1500,0,1465.68982666204,3,1453.81915697967,4,1500,0,0,0,0,4,0,-1.82300913767927
"Bossel A.",1476.49981514114,2,1500,0,1476.45880198446,2,1500,0,1500,0,1477.19188188217,2,1475.15359581754,2,1500,0,0,0,0,2,0,-0.940007394354343
"Ward A.",1477.48772320196,3,1500,0,1476.7455300099,2,1493.32963724077,1,1500,0,1474.98159336261,3,1480.88458507579,2,1492.14290728203,1,1,0,-0.104268088112196,2,0,-0.796222983809585
"Salamanca C.",1489.84573121318,1,1500,0,1500,0,1488.87951253558,1,1500,0,1488.89069964655,1,1489.99479309688,1,1500,0,0,0,0,1,0,-0.406170751472633
"Barrientos N.",1457.43707318936,3,1500,0,1500,0,1462.10043739133,3,1500,0,1460.73790264296,3,1457.86161785336,3,1500,0,0,0,0,3,0,-1.70251707242557
"Londero J.I.",1477.97090109643,2,1500,0,1500,0,1475.189635863,2,1500,0,1477.22482537998,2,1478.58049589971,2,1500,0,0,0,0,2,0,-0.881163956142692
"Struvay E.",1475.93035594471,2,1500,0,1500,0,1477.07040348626,2,1500,0,1476.28969306531,2,1476.14781630581,2,1500,0,0,0,0,2,0,-0.962785762211771
"King K.",1481.49083801066,2,1488.73128043191,1,1500,0,1490.14059584567,1,1500,0,1489.37651806189,1,1480.68529002017,2,1500,0,0,0,0,2,0,-0.740366479573752
"Westerhof B.",1487.8361148242,1,1500,0,1500,0,1486.47955178085,1,1500,0,1486.4192985791,1,1488.34317251784,1,1500,0,0,0,0,1,0,-0.486555407031884
"Topic J.",1492.30722055438,1,1500,0,1500,0,1492.15139686155,1,1500,0,1491.34905989753,1,1492.4767883804,1,1500,0,0,0,0,1,0,-0.307711177824948
"Setkic A.",1480.42408372099,2,1500,0,1500,0,1480.30791137298,2,1500,0,1480.77557233677,2,1479.38002369536,2,1500,0,0,0,0,2,0,-0.78303665116043
"Mcdonald M.",1452.29783080216,4,1464.47698910039,3,1489.00116532838,1,1500,0,1500,0,1487.87680448707,1,1462.74391576488,3,1487.5,1,1,0,-0.456603223279326,3,0,-1.45148354463433
"Bogaerts R.",1490.10644020174,1,1487.88770853855,1,1500,0,1500,0,1500,0,1500,0,1489.10070705158,1,1500,0,0,0,0,1,0,-0.395742391930467
"Altamirano C.",1494.72161370822,1,1492.92501461423,1,1500,0,1500,0,1500,0,1500,0,1500,0,1492.27762851442,1,1,0,-0.211135451671393,0,0,0
"Djere L.",1472.27249209686,3,1492.87424707345,1,1500,0,1477.26805670043,2,1500,0,1477.19652638925,2,1483.17183740851,2,1486.32719887443,1,1,0,-0.493974409090093,2,0,-0.615125907035607
"Trongcharoenchaikul W.",1490.78317320931,1,1490.70848245706,1,1500,0,1500,0,1500,0,1500,0,1491.28723745706,1,1500,0,0,0,0,1,0,-0.368673071627643
"Jeong S.Y.",1492.77723989852,1,1492.67904919332,1,1500,0,1500,0,1500,0,1500,0,1491.19830809065,1,1500,0,0,0,0,1,0,-0.288910404059021
"Nedovyesov O.",1487.53823021229,1,1488.23829716937,1,1500,0,1500,0,1500,0,1500,0,1487.31975031551,1,1500,0,0,0,0,1,0,-0.498470791508249
"Sekulic M.",1486.53922766997,1,1486.66301821845,1,1500,0,1500,0,1500,0,1500,0,1486.95661265684,1,1500,0,0,0,0,1,0,-0.538430893201297
"Nedunchezhiyan J.",1485.79564057211,1,1486.1654654476,1,1500,0,1500,0,1500,0,1500,0,1486.38298420753,1,1500,0,0,0,0,1,0,-0.56817437711544
"Zayed M.S.",1499.0582960393,1,1498.752634143,1,1500,0,1500,0,1500,0,1500,0,1498.4049775178,1,1500,0,0,0,0,1,0,-0.0376681584279127
"Hossam K.",1497.30707896238,1,1497.04239660238,1,1500,0,1500,0,1500,0,1500,0,1496.56655878323,1,1500,0,0,0,0,1,0,-0.107716841504762
"Struff J-L.",1496.93989029155,1,1495.97370731767,1,1500,0,1500,0,1500,0,1500,0,1496.57015414689,1,1500,0,0,0,0,1,0,-0.12240438833787
"Artunedo Martinavarro A.",1487.45143455427,1,1487.2974800958,1,1500,0,1500,0,1500,0,1500,0,1487.42938670383,1,1500,0,0,0,0,1,0,-0.501942617829194
"Lama G.",1486.45843129185,1,1500,0,1500,0,1488.43961774685,1,1500,0,1487.85073000554,1,1487.15553963515,1,1500,0,0,0,0,1,0,-0.541662748325844
"Krstin P.",1481.87201179252,2,1482.42434747718,2,1500,0,1500,0,1500,0,1500,0,1480.33176136448,2,1500,0,0,0,0,2,0,-0.725119528299317
"Hank T.",1472.72848423443,3,1471.80848409892,3,1500,0,1500,0,1500,0,1500,0,1471.43943858683,3,1500,0,0,0,0,3,0,-1.09086063062265
"Khaddari H.",1489.10636489657,1,1500,0,1500,0,1491.15824509165,1,1500,0,1490.86297169216,1,1488.60573142316,1,1500,0,0,0,0,1,0,-0.435745404137193
"Ciorcila P.",1489.60610629551,1,1500,0,1500,0,1485.71870747629,1,1500,0,1487.06510087511,1,1489.38322480089,1,1500,0,0,0,0,1,0,-0.415755748179498
"Travaglia S.",1488.98331917996,1,1500,0,1500,0,1488.66687185144,1,1500,0,1489.62543861056,1,1489.55292426006,1,1500,0,0,0,0,1,0,-0.440667232801779
"Vaisse M.",1491.51172003275,1,1500,0,1500,0,1485.10901783598,1,1500,0,1491.59914136693,1,1491.66049965399,1,1500,0,0,0,0,1,0,-0.339531198690089
"Lokoli L.",1457.08036398304,4,1464.7615116285,3,1500,0,1486.9185057054,1,1500,0,1486.53346340181,1,1478.46063439443,2,1472.51053774384,2,2,0,-0.946314577479222,2,0,-0.770470863199107
"Coppejans K.",1466.29334342128,4,1500,0,1492.25772661391,1,1471.45637016326,3,1500,0,1468.51983441708,4,1476.38155831638,3,1484.68605483103,1,1,0,-0.398400222201857,3,0,-0.949866040946794
"Smethurst D.",1496.3374768874,1,1500,0,1490.90286277132,1,1500,0,1500,0,1492.53710829532,1,1500,0,1492.16687466606,1,1,0,-0.146500924504118,0,0,0
"Thompson C.",1488.16383343301,1,1500,0,1486.9193179658,1,1500,0,1500,0,1486.88903781784,1,1488.45828080958,1,1500,0,0,0,0,1,0,-0.473446662679556
"Krueger M.",1485.68934172826,1,1500,0,1486.34871911721,1,1500,0,1500,0,1486.3403375524,1,1485.99371061754,1,1500,0,0,0,0,1,0,-0.572426330869453
"Pasha N.",1488.52233913092,1,1488.00592208211,1,1500,0,1500,0,1500,0,1500,0,1488.72818809133,1,1500,0,0,0,0,1,0,-0.459106434763083
"De Paula F.",1486.99884297384,1,1500,0,1500,0,1487.05047029068,1,1500,0,1486.82698185377,1,1486.37886640729,1,1500,0,0,0,0,1,0,-0.520046281046353
"Galovic V.",1491.22496479985,1,1500,0,1500,0,1491.35654326527,1,1500,0,1491.4334808131,1,1491.64245549643,1,1500,0,0,0,0,1,0,-0.351001408006096
"Schnur B.",1492.34817390104,1,1491.44754057869,1,1500,0,1500,0,1500,0,1500,0,1491.46451668096,1,1500,0,0,0,0,1,0,-0.306073043958423
"Giron M.",1481.72404437294,2,1483.15749808819,2,1500,0,1500,0,1500,0,1500,0,1485.04273861503,1,1492.32576191792,1,1,0,-0.138721627020203,1,0,-0.592316598062099
"Mcgee J.",1467.26828102102,3,1467.75438556628,3,1500,0,1500,0,1500,0,1500,0,1478.98325656204,2,1487.16414642599,1,1,0,-0.581082493364054,2,0,-0.728186265795302
"Takeuchi K.",1486.29309487718,1,1486.04151980741,1,1500,0,1500,0,1500,0,1500,0,1486.31256856234,1,1500,0,0,0,0,1,0,-0.548276204912765
"Burquier G.",1492.32605525443,1,1485.74814416034,1,1500,0,1500,0,1500,0,1500,0,1492.07214333963,1,1500,0,0,0,0,1,0,-0.306957789822637
"Gao X.",1487.51694617847,1,1489.12991440492,1,1500,0,1500,0,1500,0,1500,0,1488.51718160119,1,1500,0,0,0,0,1,0,-0.499322152861259
"Ouyang B.",1491.90352744179,1,1486.60531232678,1,1500,0,1500,0,1500,0,1500,0,1492.13799336731,1,1500,0,0,0,0,1,0,-0.323858902328431
"Gerasimov E.",1487.22267030358,1,1487.0248792967,1,1500,0,1500,0,1500,0,1500,0,1486.6193167209,1,1500,0,0,0,0,1,0,-0.511093187856691
"Herbert P-H.",1487.3139438164,1,1486.82591223614,1,1500,0,1500,0,1500,0,1500,0,1487.21685538702,1,1500,0,0,0,0,1,0,-0.507442247344116
"Baluda V.",1493.63536143371,1,1493.21273575949,1,1500,0,1500,0,1500,0,1500,0,1493.60916426146,1,1500,0,0,0,0,1,0,-0.254585542651681
"Gombos N.",1476.9370856116,4,1478.64898009062,3,1500,0,1489.22061271455,1,1500,0,1488.69356953313,1,1474.86249280898,4,1500,0,0,0,0,4,0,-0.922516575536168
"Prashanth V.",1488.311555852,1,1486.3374173007,1,1500,0,1500,0,1500,0,1500,0,1487.81487154195,1,1500,0,0,0,0,1,0,-0.467537765920195
"Escobar G.",1474.43479622633,2,1500,0,1500,0,1475.15581374727,2,1500,0,1474.13223300093,2,1475.08264599634,2,1500,0,0,0,0,2,0,-1.02260815094681
"Androic T.",1483.00973213837,2,1491.69844068416,1,1500,0,1489.1279656588,1,1500,0,1489.62302063964,1,1480.85638226215,2,1500,0,0,0,0,2,0,-0.679610714465055
"Quigley E.",1489.87341791847,1,1488.48690250694,1,1500,0,1500,0,1500,0,1500,0,1488.12209989784,1,1500,0,0,0,0,1,0,-0.405063283261081
"Martin F.",1476.40505871423,2,1485.45478905207,1,1487.71998047353,1,1500,0,1500,0,1487.54487473257,1,1476.65954092651,2,1500,0,0,0,0,2,0,-0.943797651430849
"Bolt A.",1488.3691407593,1,1486.06308440571,1,1500,0,1500,0,1500,0,1500,0,1488.41573757453,1,1500,0,0,0,0,1,0,-0.465234369627981
"Giustino L.",1482.18204898569,2,1500,0,1500,0,1481.17273753229,2,1500,0,1483.58594097166,2,1480.94603530446,2,1500,0,0,0,0,2,0,-0.712718040572495
"Silva F.",1485.8848968061,2,1500,0,1500,0,1481.11717793515,2,1500,0,1480.20433144495,2,1484.27099499995,2,1500,0,0,0,0,2,0,-0.5646041277561
"Lestienne C.",1486.57437504747,1,1500,0,1500,0,1486.61123932788,1,1500,0,1486.80062192747,1,1486.29412924545,1,1500,0,0,0,0,1,0,-0.537024998101098
"Vega Hernandez D.",1487.05589029435,1,1500,0,1500,0,1487.09158192461,1,1500,0,1487.27480093806,1,1486.78425954264,1,1500,0,0,0,0,1,0,-0.517764388225889
"Ilkel C.",1465.09437178874,4,1477.14237781369,2,1500,0,1481.99556879169,2,1500,0,1481.30727244928,2,1462.65250601682,4,1500,0,0,0,0,4,0,-1.39622512845021
"Gaio F.",1482.83532974565,2,1487.489619243,1,1500,0,1492.17590192971,1,1500,0,1492.59016791397,1,1481.37293999356,2,1500,0,0,0,0,2,0,-0.686586810173809
"Hamou M.",1481.01637115158,2,1500,0,1500,0,1475.41068003594,2,1500,0,1477.53230277527,2,1487.45794357771,1,1492.01907878073,1,1,0,-0.275426384817993,1,0,-0.483918769118856
"Gigounon G.",1497.00842485098,1,1500,0,1500,0,1495.62709746507,1,1500,0,1495.47075512072,1,1500,0,1494.73046162641,1,1,0,-0.119663005960734,0,0,0
"Marterer M.",1470.3564324762,4,1477.71362923062,2,1486.84014561609,1,1494.12759902202,1,1500,0,1482.67897223488,2,1468.94392806306,4,1500,0,0,0,0,4,0,-1.18574270095217
"Trevisan M.",1486.31205379646,1,1500,0,1500,0,1487.27056692095,1,1500,0,1486.15637452137,1,1486.75472405252,1,1500,0,0,0,0,1,0,-0.547517848141523
"Eubanks C.",1480.0110644464,2,1478.940052702,2,1500,0,1500,0,1500,0,1500,0,1480.36364032301,2,1500,0,0,0,0,2,0,-0.799557422143966
"King D.",1487.53654860492,1,1487.01464973823,1,1500,0,1500,0,1500,0,1500,0,1487.33981850812,1,1500,0,0,0,0,1,0,-0.498538055803326
"Shane R.",1494.38762185314,1,1493.51078321112,1,1500,0,1500,0,1500,0,1500,0,1500,0,1492.26440672176,1,1,0,-0.224495125874218,0,0,0
"Shyla Y.",1490.98260439257,1,1487.54884123697,1,1500,0,1500,0,1500,0,1500,0,1489.31207327709,1,1500,0,0,0,0,1,0,-0.360695824297087
"Uchiyama Y.",1483.81090129151,2,1481.62860271407,2,1500,0,1500,0,1500,0,1500,0,1482.87551566256,2,1500,0,0,0,0,2,0,-0.647563948339478
"Niki T.",1487.58420471544,1,1487.5157950687,1,1500,0,1500,0,1500,0,1500,0,1487.52430715704,1,1500,0,0,0,0,1,0,-0.496631811382494
"Miedler L.",1490.29008871848,1,1490.14053579824,1,1500,0,1500,0,1500,0,1500,0,1491.08518932234,1,1500,0,0,0,0,1,0,-0.388396451260802
"Anderson O.",1490.63552956221,1,1489.81309981929,1,1500,0,1500,0,1500,0,1500,0,1490.62742242537,1,1500,0,0,0,0,1,0,-0.374578817511419
"Zayid M. S.",1494.16994048496,1,1493.05168012657,1,1500,0,1500,0,1500,0,1500,0,1492.64904277863,1,1500,0,0,0,0,1,0,-0.233202380601549
"Tearney F.",1492.3011678346,1,1492.44077040194,1,1500,0,1500,0,1500,0,1500,0,1490.8101111155,1,1500,0,0,0,0,1,0,-0.307953286616047
"Lazov A.",1490.84576415141,1,1488.70841369488,1,1500,0,1500,0,1500,0,1500,0,1490.69504075675,1,1500,0,0,0,0,1,0,-0.366169433943748
"Kuzmanov D.",1489.36938729839,1,1490.10824830513,1,1500,0,1500,0,1500,0,1500,0,1489.09553005346,1,1500,0,0,0,0,1,0,-0.425224508064237
"Mmoh M.",1472.9800444466,3,1470.09169750898,3,1500,0,1500,0,1500,0,1500,0,1481.44817439807,2,1493.13103698836,1,1,0,-0.341853358226428,2,0,-0.738944863909493
"Patino L.",1490.58757679497,1,1487.35986440526,1,1500,0,1500,0,1500,0,1500,0,1490.30015545224,1,1500,0,0,0,0,1,0,-0.376496928201109
"Gomez L.",1483.40258813291,2,1477.09686427048,2,1500,0,1500,0,1500,0,1500,0,1483.25657322777,2,1500,0,0,0,0,2,0,-0.663896474683441
"Ahouda A.",1488.95256049952,1,1500,0,1500,0,1489.57530839017,1,1500,0,1488.92060019074,1,1489.09261919578,1,1500,0,0,0,0,1,0,-0.441897580019122
"Cachin P.",1489.87352387584,1,1500,0,1500,0,1488.46632806169,1,1500,0,1491.04930944215,1,1490.29584801447,1,1500,0,0,0,0,1,0,-0.40505904496653
"Linzer M.",1478.94223300689,2,1500,0,1500,0,1477.5516734018,2,1500,0,1478.90271913092,2,1478.07806857212,2,1500,0,0,0,0,2,0,-0.842310679724239
"Caruso S.",1497.14893405526,1,1500,0,1500,0,1491.78295146512,1,1500,0,1493.639703504,1,1495.90371601172,1,1500,0,0,0,0,1,0,-0.114042637789423
"Sonego L.",1492.97456596058,1,1500,0,1500,0,1491.14019425949,1,1500,0,1491.80474614708,1,1492.24425048578,1,1500,0,0,0,0,1,0,-0.281017361576987
"Ortega-Olmedo R.",1490.9149147501,1,1500,0,1500,0,1489.58579061505,1,1500,0,1489.74928391936,1,1489.92767895134,1,1500,0,0,0,0,1,0,-0.363403409995988
"Samper-Montana J.",1487.5,1,1500,0,1500,0,1487.5,1,1500,0,1487.5,1,1500,0,1487.5,1,1,0,-0.5,0,0,0
"Barrere G.",1484.6591079366,2,1486.58131564206,1,1500,0,1492.85935879235,1,1500,0,1493.41058196665,1,1487.71708917436,1,1491.35666108326,1,1,0,-0.126121728236449,1,0,-0.487513954299724
"Choinski J.",1490.40668532572,1,1500,0,1488.05651657188,1,1500,0,1500,0,1488.04954681323,1,1489.94560536605,1,1500,0,0,0,0,1,0,-0.383732586971388
"Arvidsson I.",1490.27800921616,1,1500,0,1500,0,1487.58940971391,1,1500,0,1487.97245154547,1,1489.58012498641,1,1500,0,0,0,0,1,0,-0.388879631353403
"Simonsson F.",1487.5,1,1500,0,1500,0,1487.5,1,1500,0,1487.5,1,1487.5,1,1500,0,0,0,0,1,0,-0.5
"Moeller M.",1490.34255936796,1,1500,0,1500,0,1488.03084535921,1,1500,0,1489.15404605234,1,1488.97313201228,1,1500,0,0,0,0,1,0,-0.386297625281653
"Nikles J.",1489.23342778078,1,1500,0,1500,0,1487.44126097088,1,1500,0,1488.71128363779,1,1489.28885839927,1,1500,0,0,0,0,1,0,-0.430662888768765
"Bellier A.",1489.08330897485,1,1500,0,1500,0,1489.04186926424,1,1500,0,1489.03977427636,1,1489.08124404558,1,1500,0,0,0,0,1,0,-0.436667641005816
"Santillan A.",1472.91744353471,2,1486.61724373009,1,1500,0,1484.88376132545,1,1500,0,1484.1157610103,1,1473.48684049285,2,1500,0,0,0,0,2,0,-1.08330225861166
"Serdarusic N.",1488.46667195408,1,1500,0,1500,0,1488.36380673233,1,1500,0,1487.65394687471,1,1487.18511761979,1,1500,0,0,0,0,1,0,-0.461333121836637
"Lopez-Perez E.",1493.85623804006,1,1500,0,1500,0,1492.61185433874,1,1500,0,1491.84207993894,1,1494.33258257108,1,1500,0,0,0,0,1,0,-0.245750478397751
"Smith A.",1489.08845874591,1,1489.01735960392,1,1500,0,1500,0,1500,0,1500,0,1489.26983568463,1,1500,0,0,0,0,1,0,-0.436461650163448
"Van Rijthoven T.",1491.82807560269,1,1486.64587689285,1,1500,0,1500,0,1500,0,1500,0,1490.69339764777,1,1500,0,0,0,0,1,0,-0.326876975892517
"Myneni S.",1492.24272959385,1,1487.54485424924,1,1500,0,1500,0,1500,0,1500,0,1500,0,1487.88182656967,1,1,0,-0.310290816245841,0,0,0
"Ivashka I.",1493.72831173509,1,1490.88504809359,1,1500,0,1500,0,1500,0,1500,0,1500,0,1487.2256319326,1,1,0,-0.250867530596323,0,0,0
"Maden Y.",1495.41905772256,1,1494.7876634704,1,1500,0,1500,0,1500,0,1500,0,1495.02867511745,1,1500,0,0,0,0,1,0,-0.183237691097644
"De Loore J.",1489.02227912686,1,1488.64435793348,1,1500,0,1500,0,1500,0,1500,0,1489.20573603127,1,1500,0,0,0,0,1,0,-0.439108834925787
